Date,MMWR_week,Location,Date Type,Short Name,Long Name,Percent of Total Pop with at least One Dose,Percent of Total Pop Fully Vaccinated,Percent of Total Fully Vaccinated Pop with a First Booster Dose,Administered,Total Doses Administered Daily,Daily Count People Receiving Dose 1,Total Doses Administered Cumulative,People Receiving 1 or More Doses Cumulative,7-Day Avg Daily Count Dose 1,7-Day Avg Total Doses Daily,Daily Count of People Fully Vaccinated,People Fully Vaccinated Cumulative,7-Day Avg Daily Count of People Fully Vaccinated,Daily Count People Receiving a First Booster Dose,People Receiving a First Booster Dose Cumulative,7-Day Average Daily Count First Booster
2020-12-14,N/A,CA,Admin,CAA,California,0,0,0,2913,68,61,2913,2133,1067,1457,21,1131,566,0,0,0
2020-12-15,N/A,CA,Admin,CAA,California,0,0,0,4262,1349,1520,4262,3653,1218,1421,35,1166,389,0,0,0
2020-12-16,N/A,CA,Admin,CAA,California,0,0,0,14368,10106,10235,14368,13888,3472,3592,23,1189,297,0,0,0
2020-12-17,N/A,CA,Admin,CAA,California,0.1,0,0,44725,30357,30287,44725,44175,8835,8945,59,1248,250,0,0,0
2020-12-18,N/A,CA,Admin,CAA,California,0.2,0,0,95151,50426,50401,95151,94576,15763,15859,38,1286,214,0,0,0
2020-12-19,N/A,CA,Admin,CAA,California,0.3,0,0,122668,27517,27378,122668,121954,17422,17524,24,1310,187,0,0,0
2020-12-20,N/A,CA,Admin,CAA,California,0.4,0,0,143022,20354,20204,143022,142158,20012,20025,27,1337,32,0,0,0
2020-12-21,N/A,CA,Admin,CAA,California,0.5,0,0,195500,52478,52245,195500,194403,27467,27512,51,1388,37,0,0,0
2020-12-22,N/A,CA,Admin,CAA,California,0.6,0,0,250846,55346,55075,250846,249478,35118,35226,73,1461,42,0,0,0
2020-12-23,N/A,CA,Admin,CAA,California,0.8,0,0,307890,57044,56782,307890,306260,41767,41932,56,1517,47,0,0,0
2020-12-24,N/A,CA,Admin,CAA,California,0.8,0,0,334699,26809,26660,334699,332920,41249,41425,25,1542,42,0,0,0
2020-12-25,N/A,CA,Admin,CAA,California,0.8,0,0,337210,2511,2497,337210,335417,34406,34580,9,1551,38,0,0,0
2020-12-26,N/A,CA,Admin,CAA,California,0.9,0,0,353657,16447,16348,353657,351765,32830,32998,18,1569,37,0,0,0
2020-12-27,N/A,CA,Admin,CAA,California,0.9,0,0,364254,10597,10540,364254,362305,31450,31605,24,1593,37,0,0,0
2020-12-28,N/A,CA,Admin,CAA,California,1,0,0,416951,52697,52137,416951,414442,31434,31636,141,1734,49,0,0,0
2020-12-29,N/A,CA,Admin,CAA,California,1.2,0,0,477537,60586,59829,477537,474271,32113,32384,126,1860,57,0,0,0
2020-12-30,N/A,CA,Admin,CAA,California,1.4,0,0,546539,69002,68087,546539,542358,33728,34093,595,2455,134,0,0,0
2020-12-31,N/A,CA,Admin,CAA,California,1.5,0,0,581664,35125,35056,581664,577414,34928,35281,56,2511,138,0,0,0
2021-01-01,N/A,CA,Admin,CAA,California,1.5,0,0,587963,6299,6278,587963,583692,35468,35822,131,2642,156,0,0,0
2021-01-02,N/A,CA,Admin,CAA,California,1.5,0,0,607568,19605,19505,607568,603197,35919,36273,67,2709,163,0,0,0
2021-01-03,N/A,CA,Admin,CAA,California,1.5,0,0,614334,6766,6708,614334,609905,35371,35726,80,2789,171,0,0,0
2021-01-04,N/A,CA,Admin,CAA,California,1.7,0,0,664932,50598,47766,664932,657671,34747,35426,2811,5600,552,0,0,0
2021-01-05,N/A,CA,Admin,CAA,California,1.8,0,0,727774,62842,56352,727774,714023,34250,35748,6156,11756,1414,0,0,0
2021-01-06,N/A,CA,Admin,CAA,California,2,0.1,0,810463,82689,65134,810463,779157,33828,37703,17423,29179,3818,0,0,0
2021-01-07,N/A,CA,Admin,CAA,California,2.1,0.2,0,914754,104291,69240,914754,848397,38712,47584,34805,63984,8782,0,0,0
2021-01-08,N/A,CA,Admin,CAA,California,2.3,0.3,0,1036518,121764,76406,1036518,924803,48730,64079,46269,110253,15373,0,0,0
2021-01-09,N/A,CA,Admin,CAA,California,2.4,0.3,0,1084692,48174,30190,1084692,954993,50257,68161,17909,128162,17922,0,0,0
2021-01-10,N/A,CA,Admin,CAA,California,2.5,0.4,0,1111433,26741,14404,1111433,969397,51356,71014,12087,140249,19637,0,0,0
2021-01-11,N/A,CA,Admin,CAA,California,2.6,0.5,0,1225619,114186,68582,1225619,1037979,54330,80098,45046,185295,25671,0,0,0
2021-01-12,N/A,CA,Admin,CAA,California,2.8,0.6,0,1351411,125792,81700,1351411,1119679,57951,89091,43931,229226,31067,0,0,0
2021-01-13,N/A,CA,Admin,CAA,California,3.1,0.7,0,1481706,130295,93553,1481706,1213232,62011,95892,36149,265375,33742,0,0,0
2021-01-14,N/A,CA,Admin,CAA,California,3.4,0.7,0,1618243,136537,115345,1618243,1328577,68597,100498,20785,286160,31739,0,0,0
2021-01-15,N/A,CA,Admin,CAA,California,3.7,0.8,0,1771719,153476,135984,1771719,1464561,77108,105029,17200,303360,27587,0,0,0
2021-01-16,N/A,CA,Admin,CAA,California,3.9,0.8,0,1859593,87874,79345,1859593,1543906,84130,110700,8406,311766,26229,0,0,0
2021-01-17,N/A,CA,Admin,CAA,California,4,0.8,0,1912080,52487,47652,1912080,1591558,88880,114378,4493,316259,25144,0,0,0
2021-01-18,N/A,CA,Admin,CAA,California,4.2,0.9,0,2004012,91932,71419,2004012,1662977,89285,111199,20123,336382,21584,0,0,0
2021-01-19,N/A,CA,Admin,CAA,California,4.5,0.9,0,2165307,161295,124681,2165307,1787658,95426,116271,34974,371356,20304,0,0,0
2021-01-20,N/A,CA,Admin,CAA,California,4.9,1,0,2346812,181505,141071,2346812,1928729,102214,123587,38651,410007,20662,0,0,0
2021-01-21,N/A,CA,Admin,CAA,California,5.3,1.1,0,2535532,188720,165643,2535532,2094372,109399,131041,22245,432252,20870,0,0,0
2021-01-22,N/A,CA,Admin,CAA,California,5.7,1.1,0,2724398,188866,171442,2724398,2265814,114465,136097,16660,448912,20793,0,0,0
2021-01-23,N/A,CA,Admin,CAA,California,6,1.2,0,2845354,120956,107628,2845354,2373442,118505,140823,12937,461849,21440,0,0,0
2021-01-24,N/A,CA,Admin,CAA,California,6.2,1.2,0,2910583,65229,59534,2910583,2432976,120203,142643,4875,466724,21495,0,0,0
2021-01-25,N/A,CA,Admin,CAA,California,6.5,1.3,0,3066784,156201,116445,3066784,2549421,126635,151825,39196,505920,24220,0,0,0
2021-01-26,N/A,CA,Admin,CAA,California,6.8,1.4,0,3254055,187271,144046,3254055,2693467,129401,155535,41976,547896,25220,0,0,0
2021-01-27,N/A,CA,Admin,CAA,California,7.2,1.5,0,3456895,202840,158278,3456895,2851745,131859,158583,43515,591411,25915,0,0,0
2021-01-28,N/A,CA,Admin,CAA,California,7.6,1.6,0,3665918,209023,168535,3665918,3020280,132273,161484,39646,631057,28401,0,0,0
2021-01-29,N/A,CA,Admin,CAA,California,8.1,1.7,0,3870756,204838,164106,3870756,3184386,131225,163765,40700,671757,31835,0,0,0
2021-01-30,N/A,CA,Admin,CAA,California,8.4,1.7,0,4008268,137512,120113,4008268,3304499,133008,166131,16840,688597,32393,0,0,0
2021-01-31,N/A,CA,Admin,CAA,California,8.5,1.8,0,4084001,75733,69592,4084001,3374091,134445,167631,5600,694197,32496,0,0,0
2021-02-01,N/A,CA,Admin,CAA,California,8.9,1.9,0,4260487,176486,132599,4260487,3506690,136753,170529,43082,737279,33051,0,0,0
2021-02-02,N/A,CA,Admin,CAA,California,9.3,2,0,4469268,208781,156594,4469268,3663284,138545,173602,51651,788930,34433,0,0,0
2021-02-03,N/A,CA,Admin,CAA,California,9.7,2.1,0,4702772,233504,172918,4702772,3836202,140637,177982,59578,848508,36728,0,0,0
2021-02-04,N/A,CA,Admin,CAA,California,10.2,2.3,0,4955116,252344,182476,4955116,4018678,142628,184171,68929,917437,40911,0,0,0
2021-02-05,N/A,CA,Admin,CAA,California,10.6,2.5,0,5224792,269676,182580,5224792,4201258,145267,193434,86103,1003540,47398,0,0,0
2021-02-06,N/A,CA,Admin,CAA,California,11,2.6,0,5392739,167947,130935,5392739,4332193,146813,197782,37033,1040573,50282,0,0,0
2021-02-07,N/A,CA,Admin,CAA,California,11.1,2.7,0,5465843,73104,55210,5465843,4387403,144759,197406,17360,1057933,51962,0,0,0
2021-02-08,N/A,CA,Admin,CAA,California,11.4,2.8,0,5664956,199113,131694,5664956,4519097,144630,200638,67094,1125027,55393,0,0,0
2021-02-09,N/A,CA,Admin,CAA,California,11.8,3.1,0,5896287,231331,140604,5896287,4659701,142345,203860,90498,1215525,60942,0,0,0
2021-02-10,N/A,CA,Admin,CAA,California,12.2,3.4,0,6165405,269118,149919,6165405,4809620,139060,208948,118800,1334325,69402,0,0,0
2021-02-11,N/A,CA,Admin,CAA,California,12.6,3.7,0,6452879,287474,158795,6452879,4968415,135677,213966,127614,1461939,77786,0,0,0
2021-02-12,N/A,CA,Admin,CAA,California,13,4,0,6746035,293156,158841,6746035,5127256,132285,217320,133375,1595314,84539,0,0,0
2021-02-13,N/A,CA,Admin,CAA,California,13.2,4.2,0,6930919,184884,103496,6930919,5230752,128366,219740,78378,1673692,90446,0,0,0
2021-02-14,N/A,CA,Admin,CAA,California,13.4,4.3,0,7034275,103356,58504,7034275,5289256,128836,224062,44303,1717995,94295,0,0,0
2021-02-15,N/A,CA,Admin,CAA,California,13.6,4.5,0,7185236,150961,83829,7185236,5373085,121998,217183,66009,1784004,94140,0,0,0
2021-02-16,N/A,CA,Admin,CAA,California,14,4.8,0,7459095,273859,145725,7459095,5518810,122730,223258,126212,1910216,99242,0,0,0
2021-02-17,N/A,CA,Admin,CAA,California,14.3,5.2,0,7742133,283038,139137,7742133,5657947,121190,225247,142059,2052275,102564,0,0,0
2021-02-18,N/A,CA,Admin,CAA,California,14.7,5.6,0,8041973,299840,145039,8041973,5802986,119224,227013,153245,2205520,106226,0,0,0
2021-02-19,N/A,CA,Admin,CAA,California,15.1,5.9,0,8321220,279247,145861,8321220,5948847,117370,225026,132709,2338229,106131,0,0,0
2021-02-20,N/A,CA,Admin,CAA,California,15.3,6.1,0,8493233,172013,93380,8493233,6042227,115925,223188,78049,2416278,106084,0,0,0
2021-02-21,N/A,CA,Admin,CAA,California,15.4,6.2,0,8586119,92886,47610,8586119,6089837,114369,221692,44713,2460991,106142,0,0,0
2021-02-22,N/A,CA,Admin,CAA,California,15.6,6.5,0,8771621,185502,92762,8771621,6182599,115645,226626,91865,2552856,109836,0,0,0
2021-02-23,N/A,CA,Admin,CAA,California,15.9,6.8,0,9024423,252802,118724,9024423,6301323,111788,223618,132633,2685489,110753,0,0,0
2021-02-24,N/A,CA,Admin,CAA,California,16.3,7.2,0,9339602,315179,149822,9339602,6451145,113314,228210,164351,2849840,113938,0,0,0
2021-02-25,N/A,CA,Admin,CAA,California,16.8,7.6,0,9696154,356552,186408,9696154,6637553,119224,236312,169669,3019509,116284,0,0,0
2021-02-26,N/A,CA,Admin,CAA,California,17.3,8.1,0,10081385,385231,210987,10081385,6848540,128528,251452,172813,3192322,122013,0,0,0
2021-02-27,N/A,CA,Admin,CAA,California,17.7,8.4,0,10354045,272660,151205,10354045,6999745,136788,265830,120559,3312881,128086,0,0,0
2021-02-28,N/A,CA,Admin,CAA,California,17.9,8.5,0,10499463,145418,84014,10499463,7083759,141989,273335,60705,3373586,130371,0,0,0
2021-03-01,N/A,CA,Admin,CAA,California,18.3,8.8,0,10766776,267313,153575,10766776,7237334,150676,285022,113325,3486911,133436,0,0,0
2021-03-02,N/A,CA,Admin,CAA,California,18.8,9.2,0,11084671,317895,186930,11084671,7424264,160420,294321,130301,3617212,133103,0,0,0
2021-03-03,N/A,CA,Admin,CAA,California,19.3,9.5,0,11447487,362816,209507,11447487,7633771,168947,301126,152643,3769855,131431,0,0,0
2021-03-04,N/A,CA,Admin,CAA,California,19.9,9.9,0,11830406,382919,222241,11830406,7856012,174066,304893,160900,3930755,130178,0,0,0
2021-03-05,N/A,CA,Admin,CAA,California,20.5,10.3,0,12195486,365080,226742,12195486,8082754,176316,302014,139813,4070568,125464,0,0,0
2021-03-06,N/A,CA,Admin,CAA,California,20.9,10.5,0,12459026,263540,172907,12459026,8255661,179417,300712,97772,4168340,122208,0,0,0
2021-03-07,N/A,CA,Admin,CAA,California,21.1,10.7,0,12596216,137190,93659,12596216,8349320,180794,299536,50399,4218739,120736,0,0,0
2021-03-08,N/A,CA,Admin,CAA,California,21.5,10.9,0,12831314,235098,163664,12831314,8512984,182236,294934,82292,4301031,116303,0,0,0
2021-03-09,N/A,CA,Admin,CAA,California,22,11.2,0,13139673,308359,191479,13139673,8704463,182886,293572,133247,4434278,116724,0,0,0
2021-03-10,N/A,CA,Admin,CAA,California,22.6,11.6,0,13480631,340958,210623,13480631,8915086,183045,290449,155629,4589907,117150,0,0,0
2021-03-11,N/A,CA,Admin,CAA,California,23.2,12.1,0,13878479,397848,238717,13878479,9153803,185399,292582,193517,4783424,121810,0,0,0
2021-03-12,N/A,CA,Admin,CAA,California,23.8,12.7,0,14297852,419373,250160,14297852,9403963,188744,300338,216249,4999673,132729,0,0,0
2021-03-13,N/A,CA,Admin,CAA,California,24.3,13,0,14590150,292298,189258,14590150,9593221,191080,304446,134365,5134038,137957,0,0,0
2021-03-14,N/A,CA,Admin,CAA,California,24.5,13.2,0,14748137,157987,95986,14748137,9689207,191412,307417,77044,5211082,141763,0,0,0
2021-03-15,N/A,CA,Admin,CAA,California,25,13.5,0,15048280,300143,186297,15048280,9875504,194646,316709,134960,5346042,149287,0,0,0
2021-03-16,N/A,CA,Admin,CAA,California,25.6,13.9,0,15427668,379388,238185,15427668,10113689,201318,326856,159301,5505343,153009,0,0,0
2021-03-17,N/A,CA,Admin,CAA,California,26.3,14.3,0,15827853,400185,267623,15827853,10381312,209461,335317,151631,5656974,152438,0,0,0
2021-03-18,N/A,CA,Admin,CAA,California,27,14.7,0,16249092,421239,269712,16249092,10651024,213889,338659,170608,5827582,149165,0,0,0
2021-03-19,N/A,CA,Admin,CAA,California,27.7,15.2,0,16681564,432472,274440,16681564,10925464,217357,340530,181304,6008886,144173,0,0,0
2021-03-20,N/A,CA,Admin,CAA,California,28.2,15.5,0,16985981,304417,206149,16985981,11131613,219770,342262,114627,6123513,141354,0,0,0
2021-03-21,N/A,CA,Admin,CAA,California,28.4,15.6,0,17131699,145718,98686,17131699,11230299,220156,340509,55484,6178997,138274,0,0,0
2021-03-22,N/A,CA,Admin,CAA,California,28.9,15.9,0,17415379,283680,195009,17415379,11425308,221401,338157,100435,6279432,133341,0,0,0
2021-03-23,N/A,CA,Admin,CAA,California,29.5,16.3,0,17792842,377463,245204,17792842,11670512,222403,337882,144545,6423977,131233,0,0,0
2021-03-24,N/A,CA,Admin,CAA,California,30.2,16.7,0,18201946,409104,252458,18201946,11922970,220237,339156,171544,6595521,134078,0,0,0
2021-03-25,N/A,CA,Admin,CAA,California,30.9,17.2,0,18647406,445460,270922,18647406,12193892,220410,342616,191673,6787194,137087,0,0,0
2021-03-26,N/A,CA,Admin,CAA,California,31.6,17.7,0,19111653,464247,272700,19111653,12466592,220161,347156,208765,6995959,141010,0,0,0
2021-03-27,N/A,CA,Admin,CAA,California,32,18.1,0,19440889,329236,183271,19440889,12649863,216893,350701,157457,7153416,147129,0,0,0
2021-03-28,N/A,CA,Admin,CAA,California,32.3,18.3,0,19618747,177858,97643,19618747,12747506,216744,355293,83711,7237127,151161,0,0,0
2021-03-29,N/A,CA,Admin,CAA,California,32.8,18.7,0,19949458,330711,194982,19949458,12942488,216740,362011,146109,7383236,157686,0,0,0
2021-03-30,N/A,CA,Admin,CAA,California,33.4,19.2,0,20373350,423892,257689,20373350,13200177,218524,368644,185887,7569123,163592,0,0,0
2021-03-31,N/A,CA,Admin,CAA,California,34.1,19.7,0,20821729,448379,273815,20821729,13473992,221575,374255,198460,7767583,167437,0,0,0
2021-04-01,N/A,CA,Admin,CAA,California,34.9,20.2,0,21343045,521316,331573,21343045,13805565,230239,385091,233110,8000693,173357,0,0,0
2021-04-02,N/A,CA,Admin,CAA,California,35.8,20.8,0,21846422,503377,320775,21846422,14126340,237107,390681,228709,8229402,176206,0,0,0
2021-04-03,N/A,CA,Admin,CAA,California,36.3,21.3,0,22190086,343664,217563,22190086,14343903,242006,392742,169540,8398942,177932,0,0,0
2021-04-04,N/A,CA,Admin,CAA,California,36.5,21.4,0,22326396,136310,79390,22326396,14423293,239398,386807,76175,8475117,176856,0,0,0
2021-04-05,N/A,CA,Admin,CAA,California,37.1,21.9,0,22701672,375276,226762,22701672,14650055,243938,393173,191865,8666982,183392,0,0,0
2021-04-06,N/A,CA,Admin,CAA,California,37.9,22.6,0,23185820,484148,308111,23185820,14958166,251141,401781,246952,8913934,192116,0,0,0
2021-04-07,N/A,CA,Admin,CAA,California,38.7,23.2,0,23685866,500046,319449,23685866,15277615,257660,409162,255402,9169336,200250,0,0,0
2021-04-08,N/A,CA,Admin,CAA,California,39.5,23.9,0,24212562,526696,338788,24212562,15616403,258691,409931,277734,9447070,206625,0,0,0
2021-04-09,N/A,CA,Admin,CAA,California,40.3,24.6,0,24735039,522477,326583,24735039,15942986,259521,412660,282264,9729334,214276,0,0,0
2021-04-10,N/A,CA,Admin,CAA,California,41,25.2,0,25126786,391747,247684,25126786,16190670,263824,419529,224792,9954126,222169,0,0,0
2021-04-11,N/A,CA,Admin,CAA,California,41.3,25.5,0,25324404,197618,119800,25324404,16310470,269597,428287,113720,10067846,227533,0,0,0
2021-04-12,N/A,CA,Admin,CAA,California,41.8,26,0,25678605,354201,204459,25678605,16514929,266411,425276,190184,10258030,227293,0,0,0
2021-04-13,N/A,CA,Admin,CAA,California,42.5,26.5,0,26132135,453530,258280,26132135,16773209,259292,420902,197127,10455157,220175,0,0,0
2021-04-14,N/A,CA,Admin,CAA,California,43.1,27,0,26600163,468028,247225,26600163,17020434,248974,416328,221520,10676677,215334,0,0,0
2021-04-15,N/A,CA,Admin,CAA,California,43.8,27.6,0,27113821,513658,287553,27113821,17307987,241655,414466,227045,10903722,208093,0,0,0
2021-04-16,N/A,CA,Admin,CAA,California,44.5,28.2,0,27613730,499909,267815,27613730,17575802,233259,411242,232581,11136303,200996,0,0,0
2021-04-17,N/A,CA,Admin,CAA,California,45,28.6,0,27971797,358067,207133,27971797,17782935,227466,406430,150825,11287128,190429,0,0,0
2021-04-18,N/A,CA,Admin,CAA,California,45.2,28.8,0,28139172,167375,86266,28139172,17869201,222676,402110,81170,11368298,185779,0,0,0
2021-04-19,N/A,CA,Admin,CAA,California,45.6,29.2,0,28473530,334358,158865,28473530,18028066,216162,399275,175804,11544102,183725,0,0,0
2021-04-20,N/A,CA,Admin,CAA,California,46.2,29.8,0,28907345,433815,214879,28907345,18242945,209962,396459,219007,11763109,186850,0,0,0
2021-04-21,N/A,CA,Admin,CAA,California,46.7,30.4,0,29364482,457137,220680,29364482,18463625,206170,394903,237192,12000301,189089,0,0,0
2021-04-22,N/A,CA,Admin,CAA,California,47.3,31,0,29841288,476806,214785,29841288,18678410,195775,389638,262561,12262862,194163,0,0,0
2021-04-23,N/A,CA,Admin,CAA,California,47.8,31.7,0,30306148,464860,213473,30306148,18891883,188012,384631,251769,12514631,196904,0,0,0
2021-04-24,N/A,CA,Admin,CAA,California,48.3,32.1,0,30644177,338029,175907,30644177,19067790,183551,381769,162387,12677018,198556,0,0,0
2021-04-25,N/A,CA,Admin,CAA,California,48.5,32.3,0,30800397,156220,84270,30800397,19152060,183266,380175,72042,12749060,197252,0,0,0
2021-04-26,N/A,CA,Admin,CAA,California,48.8,32.7,0,31115991,315594,141049,31115991,19293109,180720,377494,176493,12925553,197350,0,0,0
2021-04-27,N/A,CA,Admin,CAA,California,49.2,33.3,0,31503258,387267,165019,31503258,19458128,173598,370845,230314,13155867,198965,0,0,0
2021-04-28,N/A,CA,Admin,CAA,California,49.7,33.8,0,31874944,371686,163542,31874944,19621670,165435,358637,217437,13373304,196143,0,0,0
2021-04-29,N/A,CA,Admin,CAA,California,50,34.5,0,32257314,382370,151665,32257314,19773335,156418,345147,240456,13613760,192985,0,0,0
2021-04-30,N/A,CA,Admin,CAA,California,50.5,35.1,0,32655868,398554,163665,32655868,19937000,149302,335674,246717,13860477,192264,0,0,0
2021-05-01,N/A,CA,Admin,CAA,California,50.7,35.5,0,32916206,260338,103222,32916206,20040222,138919,324576,165075,14025552,192648,0,0,0
2021-05-02,N/A,CA,Admin,CAA,California,50.8,35.7,0,33038662,122456,48035,33038662,20088257,133742,319752,79385,14104937,193697,0,0,0
2021-05-03,N/A,CA,Admin,CAA,California,51.1,36.2,0,33297505,258843,87943,33297505,20176200,126156,311645,181174,14286111,194365,0,0,0
2021-05-04,N/A,CA,Admin,CAA,California,51.3,36.8,0,33634517,337012,111688,33634517,20287888,118537,304466,236585,14522696,195261,0,0,0
2021-05-05,N/A,CA,Admin,CAA,California,51.6,37.4,0,33983785,349268,109932,33983785,20397820,110879,301263,250322,14773018,199959,0,0,0
2021-05-06,N/A,CA,Admin,CAA,California,51.9,38.1,0,34350771,366986,105257,34350771,20503077,104249,299065,273111,15046129,204624,0,0,0
2021-05-07,N/A,CA,Admin,CAA,California,52.2,38.7,0,34714535,363764,110970,34714535,20614047,96721,294095,263933,15310062,207084,0,0,0
2021-05-08,N/A,CA,Admin,CAA,California,52.4,39.2,0,34955635,241100,74684,34955635,20688731,92644,291347,173940,15484002,208350,0,0,0
2021-05-09,N/A,CA,Admin,CAA,California,52.4,39.4,0,35054697,99062,29840,35054697,20718571,90045,288005,72450,15556452,207359,0,0,0
2021-05-10,N/A,CA,Admin,CAA,California,52.6,39.8,0,35272084,217387,62466,35272084,20781037,86405,282083,163606,15720058,204850,0,0,0
2021-05-11,N/A,CA,Admin,CAA,California,52.8,40.3,0,35560262,288178,85749,35560262,20866786,82700,275106,211898,15931956,201323,0,0,0
2021-05-12,N/A,CA,Admin,CAA,California,53,40.8,0,35843596,283334,86359,35843596,20953145,79332,265687,207254,16139210,195170,0,0,0
2021-05-13,N/A,CA,Admin,CAA,California,53.4,41.4,0,36174432,330836,132931,36174432,21086076,83286,260523,205860,16345070,185563,0,0,0
2021-05-14,N/A,CA,Admin,CAA,California,53.7,41.9,0,36531051,356619,149033,36531051,21235109,88723,259502,217401,16562471,178916,0,0,0
2021-05-15,N/A,CA,Admin,CAA,California,54.1,42.3,0,36820400,289349,126465,36820400,21361574,96120,266395,169339,16731810,178258,0,0,0
2021-05-16,N/A,CA,Admin,CAA,California,54.2,42.6,0,36967693,147293,63807,36967693,21425381,100973,273285,86815,16818625,180310,0,0,0
2021-05-17,N/A,CA,Admin,CAA,California,54.5,42.9,0,37218408,250715,107755,37218408,21533136,107443,278046,151240,16969865,178544,0,0,0
2021-05-18,N/A,CA,Admin,CAA,California,54.8,43.4,0,37512404,293996,123122,37512404,21656258,112782,278877,178987,17148852,173842,0,0,0
2021-05-19,N/A,CA,Admin,CAA,California,55.1,43.8,0,37802580,290176,127494,37802580,21783752,118658,279855,171137,17319989,168683,0,0,0
2021-05-20,N/A,CA,Admin,CAA,California,55.4,44.3,0,38079825,277245,116329,38079825,21900081,116286,272199,169735,17489724,163522,0,0,0
2021-05-21,N/A,CA,Admin,CAA,California,55.7,44.7,0,38372816,292991,120225,38372816,22020306,112171,263109,181458,17671182,158387,0,0,0
2021-05-22,N/A,CA,Admin,CAA,California,56,45,0,38585344,212528,97500,38585344,22117806,108033,252135,121381,17792563,151536,0,0,0
2021-05-23,N/A,CA,Admin,CAA,California,56.1,45.2,0,38679584,94240,43481,38679584,22161287,105129,244556,53681,17846244,146803,0,0,0
2021-05-24,N/A,CA,Admin,CAA,California,56.3,45.4,0,38857904,178320,79350,38857904,22240637,101072,234214,108037,17954281,140631,0,0,0
2021-05-25,N/A,CA,Admin,CAA,California,56.5,45.7,0,39055785,197881,86848,39055785,22327485,95890,220483,119834,18074115,132180,0,0,0
2021-05-26,N/A,CA,Admin,CAA,California,56.7,46,0,39246670,190885,84439,39246670,22411924,89739,206299,114875,18188990,124143,0,0,0
2021-05-27,N/A,CA,Admin,CAA,California,56.9,46.3,0,39426719,180049,82839,39426719,22494763,84955,192413,106932,18295922,115171,0,0,0
2021-05-28,N/A,CA,Admin,CAA,California,57.2,46.6,0,39621951,195232,92616,39621951,22587379,81010,178448,110204,18406126,104992,0,0,0
2021-05-29,N/A,CA,Admin,CAA,California,57.3,46.7,0,39732743,110792,55938,39732743,22643317,75073,163914,58760,18464886,96046,0,0,0
2021-05-30,N/A,CA,Admin,CAA,California,57.4,46.8,0,39782378,49635,24619,39782378,22667936,72378,157542,27854,18492740,92357,0,0,0
2021-05-31,N/A,CA,Admin,CAA,California,57.4,46.8,0,39803576,21198,8197,39803576,22676133,62214,135096,14100,18506840,78937,0,0,0
2021-06-01,N/A,CA,Admin,CAA,California,57.6,47.1,0,39978652,175076,71466,39978652,22747599,60016,131838,111391,18618231,77731,0,0,0
2021-06-02,N/A,CA,Admin,CAA,California,57.7,47.3,0,40126348,147696,65017,40126348,22812616,57242,125668,90436,18708667,74240,0,0,0
2021-06-03,N/A,CA,Admin,CAA,California,57.9,47.7,0,40303156,176808,62369,40303156,22874985,54317,125205,122096,18830763,76406,0,0,0
2021-06-04,N/A,CA,Admin,CAA,California,58.1,48,0,40506339,203183,69045,40506339,22944030,50950,126341,140817,18971580,80779,0,0,0
2021-06-05,N/A,CA,Admin,CAA,California,58.2,48.3,0,40665667,159328,50294,40665667,22994324,50144,133275,114534,19086114,88747,0,0,0
2021-06-06,N/A,CA,Admin,CAA,California,58.2,48.4,0,40730902,65235,19808,40730902,23014132,49457,135503,47971,19134085,91621,0,0,0
2021-06-07,N/A,CA,Admin,CAA,California,58.4,48.7,0,40870707,139805,48955,40870707,23063087,55279,152447,97558,19231643,103543,0,0,0
2021-06-08,N/A,CA,Admin,CAA,California,58.5,49,0,41036677,165970,57899,41036677,23120986,53341,151146,115489,19347132,104129,0,0,0
2021-06-09,N/A,CA,Admin,CAA,California,58.6,49.3,0,41196091,159414,52194,41196091,23173180,51509,152820,114435,19461567,107557,0,0,0
2021-06-10,N/A,CA,Admin,CAA,California,58.8,49.5,0,41351167,155076,53583,41351167,23226763,50254,149716,109343,19570910,105735,0,0,0
2021-06-11,N/A,CA,Admin,CAA,California,58.9,49.8,0,41518205,167038,60374,41518205,23287137,49015,144552,113940,19684850,101896,0,0,0
2021-06-12,N/A,CA,Admin,CAA,California,59,50,0,41638486,120281,38587,41638486,23325724,47343,138974,85951,19770801,97812,0,0,0
2021-06-13,N/A,CA,Admin,CAA,California,59.1,50.1,0,41684151,45665,13758,41684151,23339482,46479,136178,34233,19805034,95850,0,0,0
2021-06-14,N/A,CA,Admin,CAA,California,59.2,50.3,0,41804796,120645,47499,41804796,23386981,46271,133441,80760,19885794,93450,0,0,0
2021-06-15,N/A,CA,Admin,CAA,California,59.3,50.6,0,41943876,139080,56967,41943876,23443948,46137,129600,91433,19977227,90014,0,0,0
2021-06-16,N/A,CA,Admin,CAA,California,59.5,50.8,0,42071358,127482,53289,42071358,23497237,46294,125038,82388,20059615,85435,0,0,0
2021-06-17,N/A,CA,Admin,CAA,California,59.6,51,0,42193157,121799,53135,42193157,23550372,46230,120284,78427,20138042,81019,0,0,0
2021-06-18,N/A,CA,Admin,CAA,California,59.7,51.2,0,42328607,135450,57901,42328607,23608273,45877,115772,86051,20224093,77035,0,0,0
2021-06-19,N/A,CA,Admin,CAA,California,59.8,51.3,0,42409099,80492,34898,42409099,23643171,45350,110088,50095,20274188,71912,0,0,0
2021-06-20,N/A,CA,Admin,CAA,California,59.9,51.4,0,42441858,32759,14189,42441858,23657360,45411,108244,20168,20294356,69903,0,0,0
2021-06-21,N/A,CA,Admin,CAA,California,60,51.5,0,42517304,75446,45863,42517304,23703223,45177,101787,36558,20330914,63589,0,0,0
2021-06-22,N/A,CA,Admin,CAA,California,60.1,51.6,0,42625280,107976,49912,42625280,23753135,44170,97343,64480,20395394,59738,0,0,0
2021-06-23,N/A,CA,Admin,CAA,California,60.2,51.8,0,42726215,100935,48582,42726215,23801717,43497,93551,58803,20454197,56369,0,0,0
2021-06-24,N/A,CA,Admin,CAA,California,60.4,51.9,0,42823811,97596,47544,42823811,23849261,42698,90093,56033,20510230,53170,0,0,0
2021-06-25,N/A,CA,Admin,CAA,California,60.5,52.1,0,42937372,113561,54609,42937372,23903870,42228,86966,65153,20575383,50184,0,0,0
2021-06-26,N/A,CA,Admin,CAA,California,60.6,52.2,0,43009443,72071,33878,43009443,23937748,42082,85763,41487,20616870,48955,0,0,0
2021-06-27,N/A,CA,Admin,CAA,California,60.6,52.2,0,43042785,33342,16316,43042785,23954064,42386,85847,18626,20635496,48734,0,0,0
2021-06-28,N/A,CA,Admin,CAA,California,60.7,52.3,0,43119973,77188,39756,43119973,23993820,41514,86096,42227,20677723,49544,0,0,0
2021-06-29,N/A,CA,Admin,CAA,California,60.8,52.5,0,43210295,90322,43814,43210295,24037634,40643,83574,50738,20728461,47581,0,0,0
2021-06-30,N/A,CA,Admin,CAA,California,60.9,52.6,0,43295653,85358,43690,43295653,24081324,39944,81348,45565,20774026,45690,0,0,0
2021-07-01,N/A,CA,Admin,CAA,California,61,52.7,0,43375777,80124,40666,43375777,24121990,38961,78852,43487,20817513,43898,0,0,0
2021-07-02,N/A,CA,Admin,CAA,California,61.2,52.8,0,43466086,90309,45392,43466086,24167382,37645,75531,48998,20866511,41590,0,0,0
2021-07-03,N/A,CA,Admin,CAA,California,61.2,52.9,0,43515192,49106,24568,43515192,24191950,36315,72250,26241,20892752,39412,0,0,0
2021-07-04,N/A,CA,Admin,CAA,California,61.2,52.9,0,43518896,3704,2020,43518896,24193970,34272,68016,1987,20894739,37035,0,0,0
2021-07-05,N/A,CA,Admin,CAA,California,61.3,52.9,0,43562187,43291,22121,43562187,24216091,31753,63173,22783,20917522,34257,0,0,0
2021-07-06,N/A,CA,Admin,CAA,California,61.4,53.1,0,43654874,92687,41248,43654874,24257339,31386,63511,55571,20973093,34947,0,0,0
2021-07-07,N/A,CA,Admin,CAA,California,61.5,53.2,0,43734377,79503,38570,43734377,24295909,30655,62675,45551,21018644,34945,0,0,0
2021-07-08,N/A,CA,Admin,CAA,California,61.6,53.3,0,43810644,76267,36802,43810644,24332711,30103,62124,43656,21062300,34970,0,0,0
2021-07-09,N/A,CA,Admin,CAA,California,61.7,53.4,0,43899296,88652,43656,43899296,24376367,29855,61887,49662,21111962,35064,0,0,0
2021-07-10,N/A,CA,Admin,CAA,California,61.8,53.5,0,43953995,54699,26831,43953995,24403198,30178,62686,30399,21142361,35658,0,0,0
2021-07-11,N/A,CA,Admin,CAA,California,61.8,53.5,0,43978923,24928,12946,43978923,24416144,31739,65718,13133,21155494,37251,0,0,0
2021-07-12,N/A,CA,Admin,CAA,California,61.9,53.6,0,44049418,70495,34380,44049418,24450524,33490,69604,39898,21195392,39696,0,0,0
2021-07-13,N/A,CA,Admin,CAA,California,62,53.7,0,44124442,75024,37650,44124442,24488174,32976,67081,40721,21236113,37574,0,0,0
2021-07-14,N/A,CA,Admin,CAA,California,62.1,53.8,0,44196735,72293,36299,44196735,24524473,32652,66051,39335,21275448,36686,0,0,0
2021-07-15,N/A,CA,Admin,CAA,California,62.2,53.9,0,44269649,72914,37454,44269649,24561927,32745,65572,38449,21313897,35942,0,0,0
2021-07-16,N/A,CA,Admin,CAA,California,62.3,54.1,0,44357905,88256,46716,44357905,24608643,33182,65516,45212,21359109,35307,0,0,0
2021-07-17,N/A,CA,Admin,CAA,California,62.4,54.1,0,44414401,56496,29774,44414401,24638417,33603,65772,28848,21387957,35085,0,0,0
2021-07-18,N/A,CA,Admin,CAA,California,62.4,54.2,0,44441476,27075,14851,44441476,24653268,33875,66079,13357,21401314,35117,0,0,0
2021-07-19,N/A,CA,Admin,CAA,California,62.5,54.3,0,44513419,71943,39375,44513419,24692643,34588,66286,35883,21437197,34544,0,0,0
2021-07-20,N/A,CA,Admin,CAA,California,62.6,54.4,0,44595192,81773,45632,44595192,24738275,35729,67250,39630,21476827,34388,0,0,0
2021-07-21,N/A,CA,Admin,CAA,California,62.7,54.5,0,44675046,79854,44783,44675046,24783058,36941,68330,38617,21515444,34285,0,0,0
2021-07-22,N/A,CA,Admin,CAA,California,62.8,54.5,0,44754837,79791,46443,44754837,24829501,38225,69313,36621,21552065,34024,0,0,0
2021-07-23,N/A,CA,Admin,CAA,California,63,54.7,0,44849162,94325,55871,44849162,24885372,39533,70180,42256,21594321,33602,0,0,0
2021-07-24,N/A,CA,Admin,CAA,California,63.1,54.7,0,44906201,57039,34446,44906201,24919818,40200,70257,24551,21618872,32988,0,0,0
2021-07-25,N/A,CA,Admin,CAA,California,63.1,54.7,0,44932197,25996,19815,44932197,24939633,40909,70103,6758,21625630,32045,0,0,0
2021-07-26,N/A,CA,Admin,CAA,California,63.2,54.8,0,45005877,73680,49507,45005877,24989140,42357,70351,27286,21652916,30817,0,0,0
2021-07-27,N/A,CA,Admin,CAA,California,63.4,54.9,0,45093091,87214,54476,45093091,25043616,43620,71128,36019,21688935,30301,0,0,0
2021-07-28,N/A,CA,Admin,CAA,California,63.5,55,0,45180045,86954,55512,45180045,25099128,45153,72143,34809,21723744,29757,0,0,0
2021-07-29,N/A,CA,Admin,CAA,California,63.7,55.1,0,45264467,84422,54819,45264467,25153947,46349,72804,32942,21756686,29232,0,0,0
2021-07-30,N/A,CA,Admin,CAA,California,63.8,55.2,0,45364378,99911,63602,45364378,25217549,47454,73602,39747,21796433,28873,0,0,0
2021-07-31,N/A,CA,Admin,CAA,California,63.9,55.2,0,45425397,61019,39058,45425397,25256607,48113,74171,23653,21820086,28745,0,0,0
2021-08-01,N/A,CA,Admin,CAA,California,64,55.2,0,45456007,30610,20909,45456007,25277516,48269,74830,10328,21830414,29255,0,0,0
2021-08-02,N/A,CA,Admin,CAA,California,64.1,55.3,0,45537913,81906,55255,45537913,25332771,49090,76005,29907,21860321,29629,0,0,0
2021-08-03,N/A,CA,Admin,CAA,California,64.3,55.4,0,45629825,91912,60519,45629825,25393290,49953,76676,34903,21895224,29470,0,0,0
2021-08-04,N/A,CA,Admin,CAA,California,64.4,55.5,0,45716735,86910,57260,45716735,25450550,50203,76670,32762,21927986,29177,0,0,0
2021-08-05,N/A,CA,Admin,CAA,California,64.6,55.6,0,45805278,88543,58381,45805278,25508931,50712,77259,33451,21961437,29250,0,0,0
2021-08-06,N/A,CA,Admin,CAA,California,64.7,55.7,0,45912568,107290,69288,45912568,25578219,51524,78313,41397,22002834,29486,0,0,0
2021-08-07,N/A,CA,Admin,CAA,California,64.8,55.7,0,45977715,65147,41671,45977715,25619890,51898,78903,25188,22028022,29705,0,0,0
2021-08-08,N/A,CA,Admin,CAA,California,64.9,55.8,0,46013441,35726,23361,46013441,25643251,52248,79633,13095,22041117,30100,0,0,0
2021-08-09,N/A,CA,Admin,CAA,California,65,55.9,0,46103508,90067,57086,46103508,25700337,52509,80799,36281,22077398,31011,0,0,0
2021-08-10,N/A,CA,Admin,CAA,California,65.2,56,0,46197064,93556,58141,46197064,25758478,52170,81034,38629,22116027,31543,0,0,0
2021-08-11,N/A,CA,Admin,CAA,California,65.3,56.1,0,46284100,87036,53199,46284100,25811677,51590,81052,37189,22153216,32176,0,0,0
2021-08-12,N/A,CA,Admin,CAA,California,65.5,56.2,0,46373575,89475,55783,46373575,25867460,51218,81185,37109,22190325,32698,0,0,0
2021-08-13,N/A,CA,Admin,CAA,California,65.6,56.3,0,46487597,114022,68741,46487597,25936201,51140,82147,48285,22238610,33682,2330,2330,333
2021-08-14,N/A,CA,Admin,CAA,California,65.7,56.4,0,46561346,73749,42478,46561346,25978679,51256,83376,30054,22268664,34377,4212,6542,935
2021-08-15,N/A,CA,Admin,CAA,California,65.8,56.4,0,46602148,40802,22311,46602148,26000990,51106,84101,16424,22285088,34853,3360,9902,1415
2021-08-16,N/A,CA,Admin,CAA,California,65.9,56.5,0.1,46701076,98928,53430,46701076,26054420,50583,85367,41821,22326909,35644,8207,18109,2587
2021-08-17,N/A,CA,Admin,CAA,California,66.1,56.6,0.1,46804971,103895,53984,46804971,26108404,49989,86844,45366,22372275,36607,9268,27377,3911
2021-08-18,N/A,CA,Admin,CAA,California,66.2,56.7,0.2,46908652,103681,52190,46908652,26160594,49845,89222,45058,22417333,37731,10892,38269,5467
2021-08-19,N/A,CA,Admin,CAA,California,66.3,56.8,0.2,47012022,103370,52029,47012022,26212623,49309,91207,43937,22461270,38706,11972,50241,7177
2021-08-20,N/A,CA,Admin,CAA,California,66.5,57,0.3,47141121,129099,62140,47141121,26274763,48366,93361,57098,22518368,39965,14926,65167,8977
2021-08-21,N/A,CA,Admin,CAA,California,66.6,57.1,0.3,47217949,76828,36173,47217949,26310936,47465,93800,34998,22553366,40672,8380,73547,9572
2021-08-22,N/A,CA,Admin,CAA,California,66.6,57.1,0.3,47260600,42651,20858,47260600,26331794,47258,94065,18411,22571777,40956,4647,78194,9756
2021-08-23,N/A,CA,Admin,CAA,California,66.8,57.2,0.4,47368973,108373,51571,47368973,26383365,46992,95414,48607,22620384,41925,12229,90423,10331
2021-08-24,N/A,CA,Admin,CAA,California,66.9,57.4,0.5,47477579,108606,50211,47477579,26433576,46453,96087,50278,22670662,42627,12246,102669,10756
2021-08-25,N/A,CA,Admin,CAA,California,67,57.5,0.5,47582663,105084,48913,47582663,26482489,45985,96287,48149,22718811,43068,11866,114535,10895
2021-08-26,N/A,CA,Admin,CAA,California,67.1,57.6,0.6,47689986,107323,49955,47689986,26532444,45689,96852,48641,22767452,43740,13076,127611,11053
2021-08-27,N/A,CA,Admin,CAA,California,67.3,57.8,0.6,47822037,132051,58345,47822037,26590789,45147,97274,63049,22830501,44590,15370,142981,11116
2021-08-28,N/A,CA,Admin,CAA,California,67.4,57.9,0.7,47900744,78707,33892,47900744,26624681,44821,97542,38999,22869500,45162,8159,151140,11085
2021-08-29,N/A,CA,Admin,CAA,California,67.4,57.9,0.7,47943893,43149,18656,47943893,26643337,44506,97613,20729,22890229,45493,4666,155806,11087
2021-08-30,N/A,CA,Admin,CAA,California,67.5,58.1,0.7,48048459,104566,45100,48048459,26688437,43582,97069,50839,22941068,45812,12962,168768,11192
2021-08-31,N/A,CA,Admin,CAA,California,67.7,58.2,0.8,48152196,103737,43064,48152196,26731501,42561,96374,50116,22991184,45789,14324,183092,11489
2021-09-01,N/A,CA,Admin,CAA,California,67.8,58.3,0.9,48254292,102096,45917,48254292,26777418,42133,95947,45597,23036781,45424,14246,197338,11829
2021-09-02,N/A,CA,Admin,CAA,California,67.9,58.4,0.9,48352483,98191,41895,48352483,26819313,40981,94642,45347,23082128,44954,14606,211944,12048
2021-09-03,N/A,CA,Admin,CAA,California,68,58.6,1,48474329,121846,49161,48474329,26868474,39669,93185,60398,23142526,44575,16165,228109,12161
2021-09-04,N/A,CA,Admin,CAA,California,68.1,58.7,1,48539332,65003,26285,48539332,26894759,38583,91227,33674,23176200,43814,6563,234672,11933
2021-09-05,N/A,CA,Admin,CAA,California,68.1,58.7,1,48577932,38600,16546,48577932,26911305,38281,90577,18541,23194741,43502,4152,238824,11860
2021-09-06,N/A,CA,Admin,CAA,California,68.1,58.7,1,48597503,19571,8362,48597503,26919667,33033,78435,9904,23204645,37654,1677,240501,10248
2021-09-07,N/A,CA,Admin,CAA,California,68.2,58.9,1.1,48698244,100741,35971,48698244,26955638,32020,78007,56977,23261622,38634,11266,251767,9811
2021-09-08,N/A,CA,Admin,CAA,California,68.3,59,1.1,48790826,92582,38393,48790826,26994031,30945,76648,46192,23307814,38719,11300,263067,9390
2021-09-09,N/A,CA,Admin,CAA,California,68.4,59.1,1.2,48882802,91976,38376,48882802,27032407,30442,75760,45649,23353463,38762,11557,274624,8954
2021-09-10,N/A,CA,Admin,CAA,California,68.5,59.3,1.2,48995155,112353,44895,48995155,27077302,29833,74404,58615,23412078,38507,12534,287158,8436
2021-09-11,N/A,CA,Admin,CAA,California,68.6,59.3,1.2,49059450,64295,25416,49059450,27102718,29708,74303,35095,23447173,38710,5496,292654,8283
2021-09-12,N/A,CA,Admin,CAA,California,68.6,59.4,1.3,49095342,35892,14539,49095342,27117257,29422,73916,19023,23466196,38779,3111,295765,8134
2021-09-13,N/A,CA,Admin,CAA,California,68.7,59.5,1.3,49182910,87568,34732,49182910,27151989,33189,83630,46603,23512799,44022,9131,304896,9199
2021-09-14,N/A,CA,Admin,CAA,California,68.8,59.6,1.3,49265983,83073,32198,49265983,27184187,32650,81106,45459,23558258,42377,8453,313349,8797
2021-09-15,N/A,CA,Admin,CAA,California,68.9,59.7,1.4,49348471,82488,32706,49348471,27216893,31837,79664,44923,23603181,42195,8143,321492,8346
2021-09-16,N/A,CA,Admin,CAA,California,69,59.9,1.4,49433834,85363,33483,49433834,27250376,31138,78719,46241,23649422,42280,8953,330445,7974
2021-09-17,N/A,CA,Admin,CAA,California,69.1,60,1.4,49533121,99287,37034,49533121,27287410,30015,76852,55328,23704750,41810,10718,341163,7715
2021-09-18,N/A,CA,Admin,CAA,California,69.1,60.1,1.5,49590698,57577,21886,49590698,27309296,29511,75893,31620,23736370,41314,5693,346856,7743
2021-09-19,N/A,CA,Admin,CAA,California,69.1,60.1,1.5,49623936,33238,12569,49623936,27321865,29230,75513,17832,23754202,41144,3587,350443,7811
2021-09-20,N/A,CA,Admin,CAA,California,69.2,60.2,1.5,49706325,82389,31402,49706325,27353267,28754,74774,42905,23797107,40615,11344,361787,8127
2021-09-21,N/A,CA,Admin,CAA,California,69.3,60.3,1.6,49783058,76733,29905,49783058,27383172,28426,73868,39396,23836503,39749,10459,372246,8414
2021-09-22,N/A,CA,Admin,CAA,California,69.4,60.4,1.6,49859662,76604,29516,49859662,27412688,27971,73027,39277,23875780,38943,10216,382462,8710
2021-09-23,N/A,CA,Admin,CAA,California,69.4,60.5,1.7,49933629,73967,27889,49933629,27440577,27172,71399,35652,23911432,37430,12629,395091,9235
2021-09-24,N/A,CA,Admin,CAA,California,69.5,60.6,1.8,50044792,111163,35391,50044792,27475968,26937,73096,47045,23958477,36247,31700,426791,12233
2021-09-25,N/A,CA,Admin,CAA,California,69.6,60.7,1.9,50116402,71610,20827,50116402,27496795,26786,75101,25630,23984107,35391,26839,453630,15253
2021-09-26,N/A,CA,Admin,CAA,California,69.6,60.7,2,50155638,39236,10445,50155638,27507240,26482,75957,14248,23998355,34879,15262,468892,16921
2021-09-27,N/A,CA,Admin,CAA,California,69.7,60.8,2.2,50276030,120392,32521,50276030,27539761,26642,81386,27687,24026042,32705,62597,531489,24243
2021-09-28,N/A,CA,Admin,CAA,California,69.8,60.9,2.5,50407589,131559,33329,50407589,27573090,27131,89219,36392,24062434,32276,64513,596002,31965
2021-09-29,N/A,CA,Admin,CAA,California,69.9,61,2.7,50539147,131558,32330,50539147,27605420,27533,97069,37760,24100194,32059,64252,660254,39685
2021-09-30,N/A,CA,Admin,CAA,California,69.9,61.1,3,50674257,135110,32659,50674257,27638079,28215,105804,39129,24139323,32556,66527,726781,47384
2021-10-01,N/A,CA,Admin,CAA,California,70,61.2,3.3,50823029,148772,35518,50823029,27673597,28233,111177,43183,24182506,32004,73264,800045,53322
2021-10-02,N/A,CA,Admin,CAA,California,70.1,61.3,3.4,50891989,68960,19608,50891989,27693205,28059,110798,23085,24205591,31641,27833,827878,53464
2021-10-03,N/A,CA,Admin,CAA,California,70.1,61.3,3.5,50930739,38750,11784,50930739,27704989,28250,110729,13569,24219160,31544,14059,841937,53292
2021-10-04,N/A,CA,Admin,CAA,California,70.2,61.4,3.7,51044221,113482,29059,51044221,27734048,27755,109742,31290,24250450,32058,55454,897391,52272
2021-10-05,N/A,CA,Admin,CAA,California,70.3,61.5,3.9,51157861,113640,28281,51157861,27762329,27034,107182,30695,24281145,31244,57122,954513,51216
2021-10-06,N/A,CA,Admin,CAA,California,70.3,61.5,4.2,51269472,111611,27793,51269472,27790122,26386,104332,30459,24311604,30201,55934,1010447,50028
2021-10-07,N/A,CA,Admin,CAA,California,70.4,61.6,4.4,51389439,119967,29758,51389439,27819880,25972,102169,30956,24342560,29034,62106,1072553,49396
2021-10-08,N/A,CA,Admin,CAA,California,70.5,61.7,4.7,51535178,145739,37233,51535178,27857113,26217,101736,38838,24381398,28413,72928,1145481,49348
2021-10-09,N/A,CA,Admin,CAA,California,70.6,61.8,4.8,51601072,65894,19243,51601072,27876356,26164,101298,20483,24401881,28041,27573,1173054,49311
2021-10-10,N/A,CA,Admin,CAA,California,70.6,61.8,4.9,51636782,35710,11114,51636782,27887470,26069,100863,11785,24413666,27787,13539,1186593,49237
2021-10-11,N/A,CA,Admin,CAA,California,70.7,61.9,5.1,51744608,107826,29049,51744608,27916519,26067,100055,29419,24443085,27519,51787,1238380,48713
2021-10-12,N/A,CA,Admin,CAA,California,70.7,61.9,5.3,51852564,107956,26905,51852564,27943424,25871,99243,29245,24472330,27312,54495,1292875,48337
2021-10-13,N/A,CA,Admin,CAA,California,70.8,62,5.5,51954535,101971,26535,51954535,27969959,25691,97866,27891,24500221,26945,50457,1343332,47555
2021-10-14,N/A,CA,Admin,CAA,California,70.9,62.1,5.7,52057895,103360,26220,52057895,27996179,25186,95494,27882,24528103,26506,52121,1395453,46129
2021-10-15,N/A,CA,Admin,CAA,California,70.9,62.2,5.9,52186827,128932,32174,52186827,28028353,24463,93093,34248,24562351,25850,65621,1461074,45085
2021-10-16,N/A,CA,Admin,CAA,California,71,62.2,6.1,52247129,60302,16997,52247129,28045350,24142,92294,17606,24579957,25439,27076,1488150,45014
2021-10-17,N/A,CA,Admin,CAA,California,71,62.2,6.1,52278091,30962,9673,52278091,28055023,23936,91616,9333,24589290,25089,12355,1500505,44845
2021-10-18,N/A,CA,Admin,CAA,California,71.1,62.3,6.3,52380148,102057,26732,52380148,28081755,23605,90791,28866,24618156,25010,48993,1549498,44445
2021-10-19,N/A,CA,Admin,CAA,California,71.1,62.4,6.5,52477962,97814,23010,52477962,28104765,23049,89343,26023,24644179,24550,51143,1600641,43967
2021-10-20,N/A,CA,Admin,CAA,California,71.2,62.4,6.7,52572719,94757,22841,52572719,28127606,22521,88312,25488,24669667,24207,48847,1649488,43737
2021-10-21,N/A,CA,Admin,CAA,California,71.2,62.5,6.9,52671343,98624,23217,52671343,28150823,22092,87635,26465,24696132,24004,51486,1700974,43646
2021-10-22,N/A,CA,Admin,CAA,California,71.3,62.6,7.3,52836383,165040,31910,52836383,28182733,22054,92794,34337,24730469,24017,101681,1802655,48797
2021-10-23,N/A,CA,Admin,CAA,California,71.4,62.6,7.5,52930226,93843,17828,52930226,28200561,22173,97585,18921,24749390,24205,58460,1861115,53281
2021-10-24,N/A,CA,Admin,CAA,California,71.4,62.7,7.6,52977942,47716,9628,52977942,28210189,22167,99979,9879,24759269,24283,28837,1889952,55635
2021-10-25,N/A,CA,Admin,CAA,California,71.5,62.7,8.1,53143788,165846,30257,53143788,28240446,22670,109091,30042,24789311,24451,108119,1998071,64082
2021-10-26,N/A,CA,Admin,CAA,California,71.6,62.8,8.6,53327720,183932,30678,53327720,28271124,23766,121394,30620,24819931,25107,125490,2123561,74703
2021-10-27,N/A,CA,Admin,CAA,California,71.6,62.9,9.1,53513932,186212,30542,53513932,28301666,24866,134459,29867,24849798,25733,128855,2252416,86133
2021-10-28,N/A,CA,Admin,CAA,California,71.7,63,9.6,53699833,185901,29379,53699833,28331045,25746,146927,30848,24880646,26359,129009,2381425,97207
2021-10-29,N/A,CA,Admin,CAA,California,71.8,63.1,10.2,53923782,223949,34800,53923782,28365845,26159,155343,36598,24917244,26682,155668,2537093,104920
2021-10-30,N/A,CA,Admin,CAA,California,71.8,63.1,10.5,54027839,104057,17513,54027839,28383358,26114,156802,18743,24935987,26657,69521,2606614,106500
2021-10-31,N/A,CA,Admin,CAA,California,71.9,63.1,10.6,54079036,51197,9632,54079036,28392990,26114,157299,10219,24946206,26705,32226,2638840,106984
2021-11-01,N/A,CA,Admin,CAA,California,71.9,63.2,11,54260617,181581,31798,54260617,28424788,26335,159547,32227,24978433,27017,120926,2759766,108814
2021-11-02,N/A,CA,Admin,CAA,California,72,63.3,11.6,54454962,194345,32039,54454962,28456827,26529,161035,30996,25009429,27071,134355,2894121,110080
2021-11-03,N/A,CA,Admin,CAA,California,72.1,63.4,12.1,54649526,194564,35681,54649526,28492508,27263,162228,30033,25039462,27095,131979,3026100,110526
2021-11-04,N/A,CA,Admin,CAA,California,72.2,63.4,12.6,54853421,203895,41613,54853421,28534121,29011,164798,30421,25069883,27034,135329,3161429,111429
2021-11-05,N/A,CA,Admin,CAA,California,72.4,63.5,13.2,55103337,249916,56431,55103337,28590552,32101,168508,37188,25107071,27118,160333,3321762,112096
2021-11-06,N/A,CA,Admin,CAA,California,72.5,63.6,13.5,55233768,130431,44522,55233768,28635074,35959,172276,18162,25125233,27035,69876,3391638,112146
2021-11-07,N/A,CA,Admin,CAA,California,72.5,63.6,13.6,55302137,68369,24601,55302137,28659675,38098,174729,10376,25135609,27058,34604,3426242,112486
2021-11-08,N/A,CA,Admin,CAA,California,72.7,63.7,14.1,55507298,205161,63133,55507298,28722808,42574,178097,29885,25165494,26723,115346,3541588,111689
2021-11-09,N/A,CA,Admin,CAA,California,72.9,63.8,14.6,55731295,223997,69604,55731295,28792412,47941,182333,28531,25194025,26371,128887,3670475,110908
2021-11-10,N/A,CA,Admin,CAA,California,73.1,63.8,15.1,55963577,232282,77306,55963577,28869718,53887,187722,27481,25221506,26006,130808,3801283,110740
2021-11-11,N/A,CA,Admin,CAA,California,73.3,63.9,15.5,56184822,221245,76661,56184822,28946379,58894,190200,25155,25246661,25254,122049,3923332,108843
2021-11-12,N/A,CA,Admin,CAA,California,73.5,64,16.1,56450646,265824,81199,56450646,29027578,62432,192473,32240,25278901,24547,155549,4078881,108160
2021-11-13,N/A,CA,Admin,CAA,California,73.6,64,16.4,56602476,151830,60536,56602476,29088114,64720,195530,16173,25295074,24263,76916,4155797,109166
2021-11-14,N/A,CA,Admin,CAA,California,73.7,64,16.6,56674992,72516,25130,56674992,29113244,64796,196122,8591,25303665,24008,39800,4195597,109908
2021-11-15,N/A,CA,Admin,CAA,California,73.8,64.1,17.1,56886655,211663,57693,56886655,29170937,64018,197051,27160,25330825,23619,129821,4325418,111976
2021-11-16,N/A,CA,Admin,CAA,California,74,64.2,17.6,57118729,232074,61249,57118729,29232186,62825,198205,27926,25358751,23532,145632,4471050,114368
2021-11-17,N/A,CA,Admin,CAA,California,74.1,64.2,18.2,57356756,238027,65512,57356756,29297698,61140,199026,27597,25386348,23549,147879,4618929,116807
2021-11-18,N/A,CA,Admin,CAA,California,74.3,64.3,18.8,57591468,234712,60736,57591468,29358434,58865,200949,27185,25413533,23839,149594,4768523,120742
2021-11-19,N/A,CA,Admin,CAA,California,74.5,64.4,19.4,57869330,277862,73571,57869330,29432005,57775,202669,30542,25444075,23596,176621,4945144,123752
2021-11-20,N/A,CA,Admin,CAA,California,74.6,64.4,19.8,58028826,159496,52254,58028826,29484259,56592,203764,16058,25460133,23580,93367,5038511,126102
2021-11-21,N/A,CA,Admin,CAA,California,74.7,64.5,20,58104142,75316,21764,58104142,29506023,56111,204164,8373,25468506,23549,46460,5084971,127053
2021-11-22,N/A,CA,Admin,CAA,California,74.8,64.5,20.5,58342689,238547,62284,58342689,29568307,56767,208005,27400,25495906,23583,152254,5237225,130258
2021-11-23,N/A,CA,Admin,CAA,California,75,64.6,21.1,58593194,250505,64595,58593194,29632902,57245,210638,28445,25524351,23657,160600,5397825,132396
2021-11-24,N/A,CA,Admin,CAA,California,75.1,64.7,21.6,58803174,209980,55129,58803174,29688031,55762,206631,27271,25551622,23611,130759,5528584,129951
2021-11-25,N/A,CA,Admin,CAA,California,75.1,64.7,21.6,58808163,4989,1145,58808163,29689176,47249,173814,1105,25552727,19885,2905,5531489,108995
2021-11-26,N/A,CA,Admin,CAA,California,75.2,64.7,22,58964042,155879,34611,58964042,29723787,41683,156387,26431,25579158,19298,97050,5628539,97628
2021-11-27,N/A,CA,Admin,CAA,California,75.3,64.8,22.2,59079865,115823,23489,59079865,29747276,37574,150148,27509,25606667,20933,66383,5694922,93773
2021-11-28,N/A,CA,Admin,CAA,California,75.3,64.9,22.4,59145206,65341,12635,59145206,29759911,36270,148723,17522,25624189,22240,36290,5731212,92320
2021-11-29,N/A,CA,Admin,CAA,California,75.4,65,22.8,59364576,219370,40269,59364576,29800180,33125,145984,55451,25679640,26248,126477,5857689,88638
2021-11-30,N/A,CA,Admin,CAA,California,75.5,65.1,23.3,59617914,253338,46836,59617914,29847016,30588,146389,59369,25739009,30665,150159,6007848,87146
2021-12-01,N/A,CA,Admin,CAA,California,75.7,65.3,23.9,59897861,279947,53079,59897861,29900095,30295,156384,63864,25802873,35893,166168,6174016,92205
2021-12-02,N/A,CA,Admin,CAA,California,75.8,65.5,24.6,60185645,287784,51790,60185645,29951885,37530,196783,61848,25864721,44571,177261,6351277,117113
2021-12-03,N/A,CA,Admin,CAA,California,76,65.7,25.2,60512741,327096,58007,60512741,30009892,40872,221243,75711,25940432,51611,196442,6547719,131311
2021-12-04,N/A,CA,Admin,CAA,California,76,65.8,25.6,60700020,187279,33696,60700020,30043588,42330,231451,57639,25998071,55915,97492,6645211,135756
2021-12-05,N/A,CA,Admin,CAA,California,76.1,65.9,25.7,60784899,84879,16082,60784899,30059670,42823,234242,23688,26021759,56796,46136,6691347,137162
2021-12-06,N/A,CA,Admin,CAA,California,76.2,66,26.3,61032480,247581,46452,61032480,30106122,43706,238272,50275,26072034,56056,153515,6844862,141025
2021-12-07,N/A,CA,Admin,CAA,California,76.3,66.1,26.8,61299032,266552,49860,61299032,30155982,44138,240160,52456,26124490,55069,166578,7011440,143370
2021-12-08,N/A,CA,Admin,CAA,California,76.4,66.3,27.4,61566844,267812,51020,61566844,30207002,43844,238426,56405,26180895,54003,163296,7174736,142960
2021-12-09,N/A,CA,Admin,CAA,California,76.6,66.4,28,61825884,259040,48825,61825884,30255827,43420,234320,49824,26230719,52285,162620,7337356,140868
2021-12-10,N/A,CA,Admin,CAA,California,76.7,66.5,28.6,62114215,288331,50509,62114215,30306336,42349,228782,60656,26291375,50135,179415,7516771,138436
2021-12-11,N/A,CA,Admin,CAA,California,76.8,66.7,28.9,62279452,165237,31261,62279452,30337597,42001,225633,43875,26335250,48168,91648,7608419,137601
2021-12-12,N/A,CA,Admin,CAA,California,76.8,66.7,29,62352013,72561,14108,62352013,30351705,41719,223873,16039,26351289,47076,43185,7651604,137180
2021-12-13,N/A,CA,Admin,CAA,California,76.9,66.8,29.5,62573655,221642,40400,62573655,30392105,40855,220168,43114,26394403,46053,139850,7791454,135227
2021-12-14,N/A,CA,Admin,CAA,California,77,66.9,30,62805810,232155,42941,62805810,30435046,39866,215254,43989,26438392,44843,147217,7938671,132462
2021-12-15,N/A,CA,Admin,CAA,California,77.1,67,30.6,63044422,238612,45386,63044422,30480432,39061,211083,42818,26481210,42902,152704,8091375,130948
2021-12-16,N/A,CA,Admin,CAA,California,77.3,67.1,31.1,63277719,233297,47588,63277719,30528020,38885,207405,26732,26507942,39603,160904,8252279,130703
2021-12-17,N/A,CA,Admin,CAA,California,77.4,67.2,31.7,63544093,266374,52589,63544093,30580609,39182,204268,40312,26548254,36697,175298,8427577,130115
2021-12-18,N/A,CA,Admin,CAA,California,77.5,67.3,32.1,63690084,145991,31030,63690084,30611639,39149,201519,24641,26572895,33949,91493,8519070,130093
2021-12-19,N/A,CA,Admin,CAA,California,77.5,67.3,32.2,63763953,73869,16254,63763953,30627893,39455,201706,10296,26583191,33129,48049,8567119,130788
2021-12-20,N/A,CA,Admin,CAA,California,77.6,67.4,32.8,64014918,250965,51683,64014918,30679576,41067,205895,36412,26619603,32171,164815,8731934,134354
2021-12-21,N/A,CA,Admin,CAA,California,77.8,67.5,33.4,64284441,269523,55272,64284441,30734848,42829,211233,37611,26657214,31260,178412,8910346,138811
2021-12-22,N/A,CA,Admin,CAA,California,77.9,67.6,34,64545036,260595,52905,64545036,30787753,43903,214373,37948,26695162,30565,171626,9081972,141514
2021-12-23,N/A,CA,Admin,CAA,California,78,67.6,34.5,64766596,221560,44573,64766596,30832326,43472,212697,30373,26725535,31085,147727,9229699,139631
2021-12-24,N/A,CA,Admin,CAA,California,78.1,67.7,34.6,64812885,46289,9246,64812885,30841572,37280,181256,7665,26733200,26421,29847,9259546,118853
2021-12-25,N/A,CA,Admin,CAA,California,78.1,67.7,34.6,64813799,914,276,64813799,30841848,32887,160531,114,26733314,22917,522,9260068,105857
2021-12-26,N/A,CA,Admin,CAA,California,78.1,67.7,34.8,64870548,56749,12571,64870548,30854419,32361,158085,10667,26743981,22970,34163,9294231,103873
2021-12-27,N/A,CA,Admin,CAA,California,78.2,67.8,35.2,65086183,215635,44473,65086183,30898892,31331,153038,35542,26779523,22846,137114,9431345,99916
2021-12-28,N/A,CA,Admin,CAA,California,78.3,67.9,35.8,65332433,246250,51838,65332433,30950730,30840,149713,38503,26818026,22973,157265,9588610,96895
2021-12-29,N/A,CA,Admin,CAA,California,78.5,68,36.3,65578643,246210,53362,65578643,31004092,30906,147658,37172,26855198,22862,156814,9745424,94779
2021-12-30,N/A,CA,Admin,CAA,California,78.6,68.1,36.8,65808040,229397,49694,65808040,31053786,31637,148778,34176,26889374,23406,146342,9891766,94581
2021-12-31,N/A,CA,Admin,CAA,California,78.6,68.1,37,65885605,77565,16295,65885605,31070081,32644,153246,11979,26901353,24022,49796,9941562,97431
2022-01-01,N/A,CA,Admin,CAA,California,78.6,68.1,37,65893680,8075,2428,65893680,31072509,32952,154269,1398,26902751,24205,4363,9945925,97980
2022-01-02,N/A,CA,Admin,CAA,California,78.7,68.1,37.2,65981098,87418,17893,65981098,31090402,33712,158650,15442,26918193,24887,54549,10000474,100892
2022-01-03,N/A,CA,Admin,CAA,California,78.8,68.2,37.5,66154373,173275,41638,66154373,31132040,33307,152599,28187,26946380,23837,104520,10104994,96236
2022-01-04,N/A,CA,Admin,CAA,California,78.9,68.3,38,66376857,222484,50757,66376857,31182797,33152,149203,33562,26979942,23131,139197,10244191,93654
2022-01-05,N/A,CA,Admin,CAA,California,79.1,68.4,38.4,66601460,224603,52662,66601460,31235459,33052,146117,33199,27013141,22563,139943,10384134,91244
2022-01-06,N/A,CA,Admin,CAA,California,79.2,68.5,38.9,66838228,236768,53311,66838228,31288770,33569,147170,34960,27048101,22675,149635,10533769,91715
2022-01-07,N/A,CA,Admin,CAA,California,79.3,68.6,39.5,67112758,274530,59396,67112758,31348166,39726,175308,41405,27089506,26879,174948,10708717,109594
2022-01-08,N/A,CA,Admin,CAA,California,79.4,68.6,39.8,67265252,152494,35624,67265252,31383790,44469,195939,24140,27113646,30128,93542,10802259,122333
2022-01-09,N/A,CA,Admin,CAA,California,79.5,68.6,40,67329353,64101,15473,67329353,31399263,44123,192608,9116,27122762,29224,40093,10842352,120268
2022-01-10,N/A,CA,Admin,CAA,California,79.6,68.7,40.4,67522817,193464,43835,67522817,31443098,44437,195492,29473,27152235,29408,121424,10963776,122683
2022-01-11,N/A,CA,Admin,CAA,California,79.7,68.8,40.8,67728187,205370,46353,67728187,31489451,43808,193047,30608,27182843,28986,129321,11093097,121272
2022-01-12,N/A,CA,Admin,CAA,California,79.8,68.9,41.2,67929913,201726,46598,67929913,31536049,42941,189779,29724,27212567,28489,126432,11219529,119342
2022-01-13,N/A,CA,Admin,CAA,California,79.9,68.9,41.6,68125378,195465,45384,68125378,31581433,41809,183879,27667,27240234,27448,123575,11343104,115619
2022-01-14,N/A,CA,Admin,CAA,California,80.1,69,42.2,68353632,228254,52577,68353632,31634010,40835,177268,25618,27265852,25192,150867,11493971,112179
2022-01-15,N/A,CA,Admin,CAA,California,80.1,69,42.4,68472333,118701,29937,68472333,31663947,40022,172440,12768,27278620,23568,76475,11570446,109741
2022-01-16,N/A,CA,Admin,CAA,California,80.2,69.1,42.5,68528124,55791,13854,68528124,31677801,39791,171253,7059,27285679,23274,35063,11605509,109022
2022-01-17,N/A,CA,Admin,CAA,California,80.3,69.1,42.8,68669126,141002,32245,68669126,31710046,38135,163758,20293,27305972,21962,88720,11694229,104350
2022-01-18,N/A,CA,Admin,CAA,California,80.4,69.2,43.2,68834911,165785,38166,68834911,31748212,36966,158103,27838,27333810,21567,100355,11794584,100212
2022-01-19,N/A,CA,Admin,CAA,California,80.5,69.2,43.5,68998830,163919,39532,68998830,31787744,35956,152702,27737,27361547,21283,97061,11891645,96017
2022-01-20,N/A,CA,Admin,CAA,California,80.5,69.3,43.8,69156023,157193,38127,69156023,31825871,34920,147235,26059,27387606,21053,93353,11984998,91699
2022-01-21,N/A,CA,Admin,CAA,California,80.7,69.4,44.1,69341490,185467,45160,69341490,31871031,33860,141123,23378,27410984,20733,116906,12101904,86848
2022-01-22,N/A,CA,Admin,CAA,California,80.7,69.4,44.4,69438702,97212,25727,69438702,31896758,33259,138053,10918,27421902,20469,60721,12162625,84597
2022-01-23,N/A,CA,Admin,CAA,California,80.8,69.4,44.4,69483968,45266,11894,69483968,31908652,32979,136549,7002,27428904,20461,26528,12189153,83378
2022-01-24,N/A,CA,Admin,CAA,California,80.8,69.5,44.7,69619838,135870,32735,69619838,31941387,33049,135816,23234,27452138,20881,80038,12269191,82137
2022-01-25,N/A,CA,Admin,CAA,California,80.9,69.5,44.9,69757497,137659,32247,69757497,31973634,32203,131798,26631,27478769,20708,78743,12347934,79050
2022-01-26,N/A,CA,Admin,CAA,California,81,69.6,45.2,69892804,135307,31805,69892804,32005439,31099,127711,27324,27506093,20649,76057,12423991,76049
2022-01-27,N/A,CA,Admin,CAA,California,81.1,69.7,45.4,70028556,135752,31499,70028556,32036938,30152,124648,27025,27533118,20787,77246,12501237,73748
2022-01-28,N/A,CA,Admin,CAA,California,81.2,69.8,45.7,70198783,170227,38082,70198783,32075020,29141,122470,33368,27566486,22215,98419,12599656,71107
2022-01-29,N/A,CA,Admin,CAA,California,81.2,69.8,45.9,70290038,91255,21970,70290038,32096990,28605,121619,18993,27585479,23368,50210,12649866,69606
2022-01-30,N/A,CA,Admin,CAA,California,81.3,69.8,45.9,70328437,38399,9706,70328437,32106696,28292,120638,7680,27593159,23465,21119,12670985,68833
2022-01-31,N/A,CA,Admin,CAA,California,81.3,69.9,46.1,70440691,112254,26781,70440691,32133477,27441,117265,23365,27616524,23484,61768,12732753,66223
2022-02-01,N/A,CA,Admin,CAA,California,81.4,70,46.3,70542895,102204,24717,70542895,32158194,26366,112200,22946,27639470,22957,54317,12787070,62734
2022-02-02,N/A,CA,Admin,CAA,California,81.5,70,46.4,70642831,99936,24698,70642831,32182892,25350,107147,24125,27663595,22500,50993,12838063,59153
2022-02-03,N/A,CA,Admin,CAA,California,81.5,70.1,46.6,70739886,97055,23939,70739886,32206831,24270,101619,22733,27686328,21887,50044,12888107,55267
2022-02-04,N/A,CA,Admin,CAA,California,81.6,70.1,46.7,70867780,127894,29789,70867780,32236620,23086,95571,31250,27717578,21585,66224,12954331,50668
2022-02-05,N/A,CA,Admin,CAA,California,81.6,70.2,46.8,70937489,69709,17536,70937489,32254156,22452,92493,17331,27734909,21347,34548,12988879,48430
2022-02-06,N/A,CA,Admin,CAA,California,81.7,70.2,46.9,70968544,31055,8249,70968544,32262405,22244,91444,6948,27741857,21243,15691,13004570,47655
2022-02-07,N/A,CA,Admin,CAA,California,81.7,70.3,47,71050137,81593,21402,71050137,32283807,21476,87064,19233,27761090,20652,40291,13044861,44587
2022-02-08,N/A,CA,Admin,CAA,California,81.8,70.3,47.1,71128370,78233,19294,71128370,32303101,20701,83639,20043,27781133,20238,38496,13083357,42327
2022-02-09,N/A,CA,Admin,CAA,California,81.8,70.4,47.2,71207269,78899,19666,71207269,32322767,19982,80634,20577,27801710,19731,38159,13121516,40493
2022-02-10,N/A,CA,Admin,CAA,California,81.9,70.4,47.3,71282736,75467,18355,71282736,32341122,19184,77550,19651,27821361,19290,36986,13158502,38628
2022-02-11,N/A,CA,Admin,CAA,California,81.9,70.5,47.4,71381594,98858,23299,71381594,32364421,18257,73402,25126,27846487,18416,49606,13208108,36254
2022-02-12,N/A,CA,Admin,CAA,California,81.9,70.5,47.5,71433923,52329,13398,71433923,32377819,17666,70919,13630,27860117,17887,24929,13233037,34880
2022-02-13,N/A,CA,Admin,CAA,California,82,70.5,47.5,71454003,20080,5352,71454003,32383171,17252,69351,4968,27865085,17604,9535,13242572,34000
2022-02-14,N/A,CA,Admin,CAA,California,82,70.6,47.6,71505881,51878,12570,71505881,32395741,15991,65106,13542,27878627,16791,24839,13267411,31793
2022-02-15,N/A,CA,Admin,CAA,California,82,70.6,47.7,71565097,59216,14063,71565097,32409804,15243,62390,16288,27894915,16255,27993,13295404,30292
2022-02-16,N/A,CA,Admin,CAA,California,82.1,70.6,47.7,71626730,61633,15049,71626730,32424853,14584,59923,16682,27911597,15698,29169,13324573,29008
2022-02-17,N/A,CA,Admin,CAA,California,82.1,70.7,47.8,71689360,62630,15465,71689360,32440318,14171,58089,16203,27927800,15206,29897,13354470,27995
2022-02-18,N/A,CA,Admin,CAA,California,82.2,70.7,47.9,71775331,85971,21323,71775331,32461641,13889,56248,21798,27949598,14730,41653,13396123,26859
2022-02-19,N/A,CA,Admin,CAA,California,82.2,70.8,48,71821140,45809,12593,71821140,32474234,13774,55317,11434,27961032,14416,21284,13417407,26339
2022-02-20,N/A,CA,Admin,CAA,California,82.2,70.8,48,71843250,22110,6583,71843250,32480817,13949,55607,5209,27966241,14451,9969,13427376,26401
2022-02-21,N/A,CA,Admin,CAA,California,82.2,70.8,48.1,71885652,42402,11045,71885652,32491862,13732,54253,10963,27977204,14082,19899,13447275,25695
2022-02-22,N/A,CA,Admin,CAA,California,82.3,70.8,48.1,71941648,55996,13681,71941648,32505543,13677,53793,14695,27991899,13855,26833,13474108,25529
2022-02-23,N/A,CA,Admin,CAA,California,82.3,70.9,48.2,71996460,54812,13661,71996460,32519204,13479,52819,13653,28005552,13422,26488,13500596,25146
2022-02-24,N/A,CA,Admin,CAA,California,82.3,70.9,48.3,72052026,55566,14008,72052026,32533212,13271,51809,13028,28018580,12969,27556,13528152,24812
2022-02-25,N/A,CA,Admin,CAA,California,82.4,71,48.4,72127544,75518,18294,72127544,32551506,12838,50316,17863,28036443,12406,38055,13566207,24298
2022-02-26,N/A,CA,Admin,CAA,California,82.4,71,48.4,72167676,40132,11100,72167676,32562606,12625,49505,9341,28045784,12107,19272,13585479,24010
2022-02-27,N/A,CA,Admin,CAA,California,82.4,71,48.5,72187963,20287,5900,72187963,32568506,12527,49245,4142,28049926,11955,9911,13595390,24002
2022-02-28,N/A,CA,Admin,CAA,California,82.5,71,48.6,72247400,59437,14218,72247400,32582724,12980,51678,12140,28062066,12123,32248,13627638,25766
2022-03-01,N/A,CA,Admin,CAA,California,82.5,71,48.6,72297593,50193,12720,72297593,32595444,12843,50849,10941,28073007,11587,25620,13653258,25593
2022-03-02,N/A,CA,Admin,CAA,California,82.5,71.1,48.7,72342289,44696,11927,72342289,32607371,12595,49404,11117,28084124,11225,20657,13673915,24760
2022-03-03,N/A,CA,Admin,CAA,California,82.6,71.1,48.7,72384089,41800,11082,72384089,32618453,12177,47438,10162,28094286,10815,19647,13693562,23630
2022-03-04,N/A,CA,Admin,CAA,California,82.6,71.1,48.8,72440085,55996,14743,72440085,32633196,11670,44649,14117,28108403,10280,25686,13719248,21863
2022-03-05,N/A,CA,Admin,CAA,California,82.6,71.2,48.8,72469685,29600,8505,72469685,32641701,11299,43144,7338,28115741,9994,13283,13732531,21007
2022-03-06,N/A,CA,Admin,CAA,California,82.6,71.2,48.9,72483365,13680,4441,72483365,32646142,11091,42200,2961,28118702,9825,6000,13738531,20449
2022-03-07,N/A,CA,Admin,CAA,California,82.6,71.2,48.9,72518980,35615,9802,72518980,32655944,10460,38797,8080,28126782,9245,16884,13755415,18254
2022-03-08,N/A,CA,Admin,CAA,California,82.7,71.2,49,72553875,34895,9140,72553875,32665084,9949,36612,8144,28134926,8846,16672,13772087,16976
2022-03-09,N/A,CA,Admin,CAA,California,82.7,71.2,49,72590173,36298,9814,72590173,32674898,9647,35412,8894,28143820,8528,16714,13788801,16412
2022-03-10,N/A,CA,Admin,CAA,California,82.7,71.3,49,72624933,34760,9019,72624933,32683917,9352,34406,8661,28152481,8314,16161,13804962,15914
2022-03-11,N/A,CA,Admin,CAA,California,82.7,71.3,49.1,72668850,43917,10888,72668850,32694805,8801,32681,11088,28163569,7881,20823,13825785,15220
2022-03-12,N/A,CA,Admin,CAA,California,82.8,71.3,49.1,72694406,25556,6915,72694406,32701720,8574,32103,6393,28169962,7746,11800,13837585,15008
2022-03-13,N/A,CA,Admin,CAA,California,82.8,71.3,49.1,72706580,12174,3637,72706580,32705357,8459,31888,2711,28172673,7710,5508,13843093,14937
2022-03-14,N/A,CA,Admin,CAA,California,82.8,71.3,49.2,72737752,31172,8247,72737752,32713604,8237,31253,6518,28179191,7487,15465,13858558,14735
2022-03-15,N/A,CA,Admin,CAA,California,82.8,71.3,49.2,72769729,31977,8078,72769729,32721682,8085,30836,7096,28186287,7337,15457,13874015,14561
2022-03-16,N/A,CA,Admin,CAA,California,82.8,71.4,49.3,72801923,32194,8092,72801923,32729774,7839,30250,7342,28193629,7116,15234,13889249,14350
2022-03-17,N/A,CA,Admin,CAA,California,82.9,71.4,49.3,72833161,31238,7907,72833161,32737681,7681,29747,6945,28200574,6870,14825,13904074,14159
2022-03-18,N/A,CA,Admin,CAA,California,82.9,71.4,49.4,72876295,43134,10850,72876295,32748531,7675,29635,9828,28210402,6690,20203,13924277,14070
2022-03-19,N/A,CA,Admin,CAA,California,82.9,71.4,49.4,72900128,23833,6506,72900128,32755037,7617,29389,5484,28215886,6561,10677,13934954,13910
2022-03-20,N/A,CA,Admin,CAA,California,82.9,71.4,49.4,72911665,11537,3419,72911665,32758456,7586,29298,2333,28218219,6507,5104,13940058,13852
2022-03-21,N/A,CA,Admin,CAA,California,82.9,71.4,49.4,72943050,31385,8462,72943050,32766918,7616,29328,6510,28224729,6505,14594,13954652,13728
2022-03-22,N/A,CA,Admin,CAA,California,82.9,71.4,49.5,72972216,29166,7370,72972216,32774288,7515,28927,6216,28230945,6380,13746,13968398,13483
2022-03-23,N/A,CA,Admin,CAA,California,83,71.5,49.5,73002116,29900,7305,73002116,32781593,7403,28599,6600,28237545,6274,14243,13982641,13342
2022-03-24,N/A,CA,Admin,CAA,California,83,71.5,49.6,73031007,28891,7230,73031007,32788823,7306,28264,6315,28243860,6184,13577,13996218,13163
2022-03-25,N/A,CA,Admin,CAA,California,83,71.5,49.6,73067999,36992,9455,73067999,32798278,7107,27386,8595,28252455,6008,17114,14013332,12722
2022-03-26,N/A,CA,Admin,CAA,California,83,71.5,49.6,73087255,19256,5043,73087255,32803321,6898,26732,4417,28256872,5855,8792,14022124,12453
2022-03-27,N/A,CA,Admin,CAA,California,83,71.5,49.6,73097332,10077,2754,73097332,32806075,6803,26524,2083,28258955,5819,4545,14026669,12373
2022-03-28,N/A,CA,Admin,CAA,California,83,71.5,49.7,73123296,25964,6505,73123296,32812580,6523,25749,5332,28264287,5651,12196,14038865,12030
2022-03-29,N/A,CA,Admin,CAA,California,83.1,71.5,49.7,73154917,31621,6983,73154917,32819563,6468,26100,5660,28269947,5572,12918,14051783,11912
2022-03-30,N/A,CA,Admin,CAA,California,83.1,71.6,49.8,73216406,61489,8775,73216406,32828338,6678,30613,7306,28277253,5673,16557,14068340,12243
2022-03-31,N/A,CA,Admin,CAA,California,83.1,71.6,49.8,73289942,73536,8750,73289942,32837088,6895,36991,7611,28284864,5858,17339,14085679,12780
2022-04-01,N/A,CA,Admin,CAA,California,83.1,71.6,49.9,73378203,88261,10250,73378203,32847338,7009,44315,9318,28294182,5961,20149,14105828,13214
2022-04-02,N/A,CA,Admin,CAA,California,83.1,71.6,49.9,73422306,44103,5654,73422306,32852992,7096,47864,4621,28298803,5990,9528,14115356,13319
2022-04-03,N/A,CA,Admin,CAA,California,83.2,71.6,49.9,73446903,24597,3178,73446903,32856170,7156,49939,2326,28301129,6025,5110,14120466,13400
2022-04-04,N/A,CA,Admin,CAA,California,83.2,71.6,49.9,73519761,72858,7748,73519761,32863918,7334,56638,6625,28307754,6210,14981,14135447,13797
2022-04-05,N/A,CA,Admin,CAA,California,83.2,71.7,50,73591873,72112,7955,73591873,32871873,7473,62422,6530,28314284,6334,15126,14150573,14113
2022-04-06,N/A,CA,Admin,CAA,California,83.2,71.7,50,73663119,71246,7937,73663119,32879810,7353,63816,6594,28320878,6232,14597,14165170,13833
2022-04-07,N/A,CA,Admin,CAA,California,83.2,71.7,50.1,73735613,72494,7346,73735613,32887156,7153,63667,6347,28327225,6052,14636,14179806,13447
2022-04-08,N/A,CA,Admin,CAA,California,83.3,71.7,50.1,73820727,85114,8832,73820727,32895988,6950,63218,8103,28335328,5878,17102,14196908,13011
2022-04-09,N/A,CA,Admin,CAA,California,83.3,71.7,50.1,73862227,41500,4886,73862227,32900874,6840,62846,3981,28339309,5787,8728,14205636,12897
2022-04-10,N/A,CA,Admin,CAA,California,83.3,71.7,50.1,73885223,22996,3128,73885223,32904002,6833,62617,2195,28341504,5768,4653,14210289,12832
2022-04-11,N/A,CA,Admin,CAA,California,83.3,71.7,50.2,73958067,72844,8750,73958067,32912752,6976,62615,6128,28347632,5697,14057,14224346,12700
2022-04-12,N/A,CA,Admin,CAA,California,83.3,71.8,50.2,74033951,75884,8892,74033951,32921644,7110,63154,6134,28353766,5640,14254,14238600,12575
2022-04-13,N/A,CA,Admin,CAA,California,83.3,71.8,50.3,74105171,71220,8342,74105171,32929986,7168,63150,6037,28359803,5561,14110,14252710,12506
2022-04-14,N/A,CA,Admin,CAA,California,83.4,71.8,50.3,74176208,71037,7823,74176208,32937809,7236,62942,6023,28365826,5514,13664,14266374,12367
2022-04-15,N/A,CA,Admin,CAA,California,83.4,71.8,50.3,74252237,76029,7475,74252237,32945284,7042,61644,7158,28372984,5379,15508,14281882,12139
2022-04-16,N/A,CA,Admin,CAA,California,83.4,71.8,50.3,74270938,18701,2129,74270938,32947413,6648,58387,1796,28374780,5067,4054,14285936,11471
2022-04-17,N/A,CA,Admin,CAA,California,83.4,71.8,50.3,74270938,0,4,74270938,32947417,6202,55102,2,28374782,4754,2,14285938,10807
