Date,MMWR_week,Location,Date Type,Short Name,Long Name,Percent of Total Pop with at least One Dose,Percent of Total Pop Fully Vaccinated,Percent of Total Fully Vaccinated Pop with a First Booster Dose,Administered,Total Doses Administered Daily,Daily Count People Receiving Dose 1,Total Doses Administered Cumulative,People Receiving 1 or More Doses Cumulative,7-Day Avg Daily Count Dose 1,7-Day Avg Total Doses Daily,Daily Count of People Fully Vaccinated,People Fully Vaccinated Cumulative,7-Day Avg Daily Count of People Fully Vaccinated,Daily Count People Receiving a First Booster Dose,People Receiving a First Booster Dose Cumulative,7-Day Average Daily Count First Booster
2020-12-14,N/A,US,Admin,USA,United States,0,0,0,36226,4592,4431,36226,30653,15327,18113,125,6543,3272,0,0,0
2020-12-15,N/A,US,Admin,USA,United States,0,0,0,84194,47968,45805,84194,76458,25486,28065,264,6807,2269,0,0,0
2020-12-16,N/A,US,Admin,USA,United States,0.1,0,0,243553,159359,154147,243553,230605,57651,60888,449,7256,1814,0,0,0
2020-12-17,N/A,US,Admin,USA,United States,0.1,0,0,516141,272588,265699,516141,496304,99261,103228,752,8008,1602,0,0,0
2020-12-18,N/A,US,Admin,USA,United States,0.3,0,0,932596,416455,408017,932596,904321,150720,155433,1200,9208,1535,0,0,0
2020-12-19,N/A,US,Admin,USA,United States,0.3,0,0,1114618,182022,178156,1114618,1082477,154640,159231,1067,10275,1468,0,0,0
2020-12-20,N/A,US,Admin,USA,United States,0.4,0,0,1220145,105527,103566,1220145,1186043,165689,169787,721,10996,654,0,0,0
2020-12-21,N/A,US,Admin,USA,United States,0.5,0,0,1602487,382342,375612,1602487,1561655,218715,223752,1507,12503,851,0,0,0
2020-12-22,N/A,US,Admin,USA,United States,0.6,0,0,2050671,448184,439573,2050671,2001228,274967,280925,2902,15405,1228,0,0,0
2020-12-23,N/A,US,Admin,USA,United States,0.8,0,0,2625224,574553,563099,2625224,2564327,333389,340239,2983,18388,1590,0,0,0
2020-12-24,N/A,US,Admin,USA,United States,0.8,0,0,2821285,196061,191229,2821285,2755556,322750,329306,1107,19495,1641,0,0,0
2020-12-25,N/A,US,Admin,USA,United States,0.8,0,0,2833999,12714,12554,2833999,2768110,266256,271629,106,19601,1485,0,0,0
2020-12-26,N/A,US,Admin,USA,United States,0.9,0,0,2975527,141528,138305,2975527,2906415,260563,265844,958,20559,1469,0,0,0
2020-12-27,N/A,US,Admin,USA,United States,0.9,0,0,3071819,96292,93604,3071819,3000019,259139,264525,733,21292,1471,0,0,0
2020-12-28,N/A,US,Admin,USA,United States,1.1,0,0,3663077,591258,577282,3663077,3577301,287949,294370,4223,25515,1859,0,0,0
2020-12-29,N/A,US,Admin,USA,United States,1.3,0,0,4384820,721743,703639,4384820,4280940,325673,333450,5248,30763,2194,0,0,0
2020-12-30,N/A,US,Admin,USA,United States,1.5,0,0,5227802,842982,824451,5227802,5105391,363009,371797,7796,38559,2882,0,0,0
2020-12-31,N/A,US,Admin,USA,United States,1.7,0,0,5648409,420607,411330,5648409,5516721,394452,403875,3188,41747,3179,0,0,0
2021-01-01,N/A,US,Admin,USA,United States,1.7,0,0,5755291,106882,96768,5755291,5613489,406483,417327,7118,48865,4181,0,0,0
2021-01-02,N/A,US,Admin,USA,United States,1.8,0,0,6019251,263960,256006,6019251,5869495,423297,434818,2887,51752,4456,0,0,0
2021-01-03,N/A,US,Admin,USA,United States,1.8,0,0,6158301,139050,132164,6158301,6001659,428806,440926,2461,54213,4703,0,0,0
2021-01-04,N/A,US,Admin,USA,United States,2,0,0,6815694,657393,599876,6815694,6601535,432033,450374,44918,99131,10517,0,0,0
2021-01-05,N/A,US,Admin,USA,United States,2.2,0.1,0,7646981,831287,731482,7646981,7333017,436011,466023,87541,186672,22273,0,0,0
2021-01-06,N/A,US,Admin,USA,United States,2.5,0.1,0,8669819,1022838,831959,8669819,8164976,437084,491717,172617,359289,45819,0,0,0
2021-01-07,N/A,US,Admin,USA,United States,2.7,0.2,0,9839914,1170095,867310,9839914,9032286,502224,598786,281147,640436,85527,0,0,0
2021-01-08,N/A,US,Admin,USA,United States,3,0.3,0,11076058,1236144,848443,11076058,9880729,609606,760110,363691,1004127,136466,0,0,0
2021-01-09,N/A,US,Admin,USA,United States,3.1,0.3,0,11584575,508517,370762,11584575,10251491,625999,795046,128813,1132940,154455,0,0,0
2021-01-10,N/A,US,Admin,USA,United States,3.1,0.4,0,11836126,251551,176644,11836126,10428135,632354,811118,69696,1202636,164060,0,0,0
2021-01-11,N/A,US,Admin,USA,United States,3.4,0.5,0,12906473,1070347,724563,12906473,11152698,650166,870111,322882,1525518,203770,0,0,0
2021-01-12,N/A,US,Admin,USA,United States,3.6,0.6,0,14165236,1258763,917904,14165236,12070602,676798,931179,314766,1840284,236230,0,0,0
2021-01-13,N/A,US,Admin,USA,United States,3.9,0.6,0,15489278,1324042,1030820,15489278,13101422,705207,974208,270813,2111097,250258,0,0,0
2021-01-14,N/A,US,Admin,USA,United States,4.3,0.7,0,16805630,1316352,1158053,16805630,14259475,746741,995102,135976,2247073,229520,0,0,0
2021-01-15,N/A,US,Admin,USA,United States,4.6,0.7,0,18063119,1257489,1117734,18063119,15377209,785211,998152,121001,2368074,194850,0,0,0
2021-01-16,N/A,US,Admin,USA,United States,4.8,0.7,0,18712576,649457,567082,18712576,15944291,813257,1018286,72032,2440106,186738,0,0,0
2021-01-17,N/A,US,Admin,USA,United States,4.9,0.7,0,19018568,305992,256432,19018568,16200723,824655,1026063,42181,2482287,182807,0,0,0
2021-01-18,N/A,US,Admin,USA,United States,5.1,0.8,0,19904382,885814,639202,19904382,16839925,812461,999701,228195,2710482,169281,0,0,0
2021-01-19,N/A,US,Admin,USA,United States,5.4,0.9,0,21251080,1346698,966397,21251080,17806322,819389,1012263,357007,3067489,175315,0,0,0
2021-01-20,N/A,US,Admin,USA,United States,5.7,1.1,0,22854317,1603237,1155232,22854317,18961554,837162,1052148,421713,3489202,196872,0,0,0
2021-01-21,N/A,US,Admin,USA,United States,6.1,1.1,0,24487151,1632834,1331887,24487151,20293441,861995,1097360,275308,3764510,216777,0,0,0
2021-01-22,N/A,US,Admin,USA,United States,6.5,1.2,0,26115858,1628707,1394079,26115858,21687520,901473,1150391,210011,3974521,229492,0,0,0
2021-01-23,N/A,US,Admin,USA,United States,6.8,1.2,0,27024852,908994,744288,27024852,22431808,926788,1187468,151124,4125645,240791,0,0,0
2021-01-24,N/A,US,Admin,USA,United States,6.8,1.3,0,27420971,396119,300526,27420971,22732334,933087,1200343,88517,4214162,247411,0,0,0
2021-01-25,N/A,US,Admin,USA,United States,7.1,1.4,0,28795542,1374571,860754,28795542,23593088,964738,1270166,490238,4704400,284845,0,0,0
2021-01-26,N/A,US,Admin,USA,United States,7.4,1.6,0,30459052,1663510,1053678,30459052,24646766,977206,1315425,583039,5287439,317136,0,0,0
2021-01-27,N/A,US,Admin,USA,United States,7.8,1.8,0,32393966,1934914,1252346,32393966,25899112,991080,1362807,649503,5936942,349677,0,0,0
2021-01-28,N/A,US,Admin,USA,United States,8.2,2,0,34358154,1964188,1371456,34358154,27270568,996732,1410143,559231,6496173,390238,0,0,0
2021-01-29,N/A,US,Admin,USA,United States,8.6,2.1,0,36274677,1916523,1373867,36274677,28644435,993845,1451260,497011,6993184,431238,0,0,0
2021-01-30,N/A,US,Admin,USA,United States,8.9,2.2,0,37294269,1019592,759097,37294269,29403532,995961,1467060,243020,7236204,444366,0,0,0
2021-01-31,N/A,US,Admin,USA,United States,9,2.2,0,37754534,460265,322504,37754534,29726036,999100,1476223,127533,7363737,449939,0,0,0
2021-02-01,N/A,US,Admin,USA,United States,9.2,2.4,0,39143422,1388888,771997,39143422,30498033,986421,1478269,574985,7938722,462046,0,0,0
2021-02-02,N/A,US,Admin,USA,United States,9.5,2.6,0,40841844,1698422,963875,40841844,31461908,973592,1483256,700659,8639381,478849,0,0,0
2021-02-03,N/A,US,Admin,USA,United States,9.9,2.9,0,42983024,2141180,1261143,42983024,32723051,974848,1512723,835809,9475190,505464,0,0,0
2021-02-04,N/A,US,Admin,USA,United States,10.3,3.1,0,45331382,2348358,1389433,45331382,34112484,977417,1567604,914284,10389474,556186,0,0,0
2021-02-05,N/A,US,Admin,USA,United States,10.7,3.4,0,47689147,2357765,1355998,47689147,35468482,974864,1630639,962168,11351642,622637,0,0,0
2021-02-06,N/A,US,Admin,USA,United States,10.9,3.5,0,48992281,1303134,853580,48992281,36322062,988361,1671145,422664,11774306,648300,0,0,0
2021-02-07,N/A,US,Admin,USA,United States,11,3.6,0,49437406,445125,277378,49437406,36599440,981915,1668982,157151,11931457,652531,0,0,0
2021-02-08,N/A,US,Admin,USA,United States,11.3,3.8,0,51018831,1581425,837896,51018831,37437336,991329,1696487,706242,12637699,671282,0,0,0
2021-02-09,N/A,US,Admin,USA,United States,11.6,4.1,0,52994854,1976023,1037654,52994854,38474990,1001869,1736144,896900,13534599,699317,0,0,0
2021-02-10,N/A,US,Admin,USA,United States,12,4.4,0,55302283,2307429,1229701,55302283,39704691,997377,1759894,1037410,14572009,728117,0,0,0
2021-02-11,N/A,US,Admin,USA,United States,12.3,4.7,0,57711068,2408785,1277213,57711068,40981904,981346,1768527,1090864,15662873,753343,0,0,0
2021-02-12,N/A,US,Admin,USA,United States,12.8,5.1,0,60298522,2587454,1379332,60298522,42361236,984679,1801339,1158780,16821653,781430,0,0,0
2021-02-13,N/A,US,Admin,USA,United States,13,5.2,0,61775261,1476739,870307,61775261,43231543,987069,1826140,572544,17394197,802842,0,0,0
2021-02-14,N/A,US,Admin,USA,United States,13.1,5.3,0,62368411,593150,346727,62368411,43578270,996976,1847286,229455,17623652,813171,0,0,0
2021-02-15,N/A,US,Admin,USA,United States,13.3,5.5,0,63548009,1179598,610386,63548009,44188656,964474,1789883,535569,18159221,788789,0,0,0
2021-02-16,N/A,US,Admin,USA,United States,13.5,5.7,0,65170818,1622809,797120,65170818,44985776,930112,1739423,788535,18947756,773308,0,0,0
2021-02-17,N/A,US,Admin,USA,United States,13.8,6,0,67138066,1967248,933416,67138066,45919192,887786,1690826,991442,19939198,766741,0,0,0
2021-02-18,N/A,US,Admin,USA,United States,14.1,6.3,0,68997292,1859226,834054,68997292,46753246,824477,1612318,976048,20915246,750339,0,0,0
2021-02-19,N/A,US,Admin,USA,United States,14.3,6.6,0,70966172,1968880,824090,70966172,47577336,745157,1523950,1096693,22011939,741469,0,0,0
2021-02-20,N/A,US,Admin,USA,United States,14.5,6.8,0,72273326,1307154,596988,72273326,48174324,706112,1499724,680777,22692716,756931,0,0,0
2021-02-21,N/A,US,Admin,USA,United States,14.6,6.9,0,72869778,596452,254510,72869778,48428834,692938,1500195,323829,23016545,770413,0,0,0
2021-02-22,N/A,US,Admin,USA,United States,14.8,7.2,0,74333193,1463415,617664,74333193,49046498,693977,1540741,802808,23819353,808590,0,0,0
2021-02-23,N/A,US,Admin,USA,United States,15,7.5,0,76273753,1940560,867165,76273753,49913663,703984,1586134,1027240,24846593,842691,0,0,0
2021-02-24,N/A,US,Admin,USA,United States,15.4,7.9,0,78804527,2530774,1246068,78804527,51159731,748648,1666637,1235191,26081784,877512,0,0,0
2021-02-25,N/A,US,Admin,USA,United States,15.9,8.3,0,81746136,2941609,1537786,81746136,52697517,849182,1821263,1343135,27424919,929953,0,0,0
2021-02-26,N/A,US,Admin,USA,United States,16.4,8.7,0,84863899,3117763,1673873,84863899,54371390,970579,1985390,1384123,28809042,971015,0,0,0
2021-02-27,N/A,US,Admin,USA,United States,16.7,8.9,0,86861763,1997864,1141494,86861763,55512884,1048366,2084062,818176,29627218,990643,0,0,0
2021-02-28,N/A,US,Admin,USA,United States,16.9,9,0,87718381,856618,535161,87718381,56048045,1088459,2121229,295401,29922619,986582,0,0,0
2021-03-01,N/A,US,Admin,USA,United States,17.2,9.3,0,89775931,2057550,1202247,89775931,57250292,1171971,2206105,796234,30718853,985643,0,0,0
2021-03-02,N/A,US,Admin,USA,United States,17.7,9.5,0,92242640,2466709,1464768,92242640,58715060,1257342,2281270,961482,31680335,976249,0,0,0
2021-03-03,N/A,US,Admin,USA,United States,18.2,9.9,0,95149083,2906443,1743846,95149083,60458906,1328454,2334937,1123468,32803803,960288,0,0,0
2021-03-04,N/A,US,Admin,USA,United States,18.8,10.3,0,98355774,3206691,1957858,98355774,62416764,1388464,2372805,1244730,34048533,946231,0,0,0
2021-03-05,N/A,US,Admin,USA,United States,19.4,10.6,0,101588331,3232557,2005128,101588331,64421892,1435786,2389205,1307820,35356353,935330,0,0,0
2021-03-06,N/A,US,Admin,USA,United States,19.8,10.9,0,103649351,2061020,1351598,103649351,65773490,1465801,2398227,863295,36219648,941776,0,0,0
2021-03-07,N/A,US,Admin,USA,United States,20,11,0,104575201,925850,677893,104575201,66451383,1486191,2408117,343603,36563251,948662,0,0,0
2021-03-08,N/A,US,Admin,USA,United States,20.5,11.3,0,106742350,2167149,1483733,106742350,67935116,1526403,2423774,851954,37415205,956622,0,0,0
2021-03-09,N/A,US,Admin,USA,United States,21,11.6,0,109452910,2710560,1811059,109452910,69746175,1575874,2458610,1081553,38496758,973775,0,0,0
2021-03-10,N/A,US,Admin,USA,United States,21.6,12,0,112580914,3128004,2064526,112580914,71810701,1621685,2490262,1269575,39766333,994647,0,0,0
2021-03-11,N/A,US,Admin,USA,United States,22.3,12.4,0,116024275,3443361,2278940,116024275,74089641,1667554,2524072,1400682,41167015,1016926,0,0,0
2021-03-12,N/A,US,Admin,USA,United States,23,12.9,0,119454990,3430715,2119140,119454990,76208781,1683841,2552380,1529619,42696634,1048612,0,0,0
2021-03-13,N/A,US,Admin,USA,United States,23.4,13.2,0,121648087,2193097,1385719,121648087,77594500,1688716,2571248,1019077,43715711,1070866,0,0,0
2021-03-14,N/A,US,Admin,USA,United States,23.6,13.3,0,122632744,984657,648580,122632744,78243080,1684528,2579649,426876,44142587,1082762,0,0,0
2021-03-15,N/A,US,Admin,USA,United States,24,13.6,0,124917761,2285017,1499299,124917761,79742379,1686752,2596487,870060,45012647,1085349,0,0,0
2021-03-16,N/A,US,Admin,USA,United States,24.6,13.9,0,127808804,2891043,1931947,127808804,81674326,1704022,2622271,1049578,46062225,1080781,0,0,0
2021-03-17,N/A,US,Admin,USA,United States,25.2,14.2,0,130981015,3172211,2129528,130981015,83803854,1713308,2628586,1131470,47193695,1061052,0,0,0
2021-03-18,N/A,US,Admin,USA,United States,25.9,14.6,0,134387195,3406180,2297609,134387195,86101463,1715975,2623274,1205757,48399452,1033205,0,0,0
2021-03-19,N/A,US,Admin,USA,United States,26.6,14.9,0,137729121,3341926,2215997,137729121,88317460,1729811,2610590,1224198,49623650,989574,0,0,0
2021-03-20,N/A,US,Admin,USA,United States,27,15.2,0,139887560,2158439,1412688,139887560,89730148,1733664,2605639,860552,50484202,966927,0,0,0
2021-03-21,N/A,US,Admin,USA,United States,27.2,15.3,0,140908880,1021320,684247,140908880,90414395,1738759,2610877,371857,50856059,959067,0,0,0
2021-03-22,N/A,US,Admin,USA,United States,27.7,15.6,0,143276563,2367683,1605733,143276563,92020128,1753964,2622686,808159,51664218,950224,0,0,0
2021-03-23,N/A,US,Admin,USA,United States,28.3,15.9,0,146346283,3069720,1985300,146346283,94005428,1761586,2648211,1153677,52817895,965096,0,0,0
2021-03-24,N/A,US,Admin,USA,United States,29,16.3,0,149909185,3562902,2211538,149909185,96216966,1773302,2704024,1424384,54242279,1006941,0,0,0
2021-03-25,N/A,US,Admin,USA,United States,29.7,16.8,0,153750868,3841683,2269459,153750868,98486425,1769280,2766239,1649991,55892270,1070403,0,0,0
2021-03-26,N/A,US,Admin,USA,United States,30.3,17.4,0,157586200,3835332,2106629,157586200,100593054,1753656,2836726,1802413,57694683,1153005,0,0,0
2021-03-27,N/A,US,Admin,USA,United States,30.7,17.7,0,160062923,2476723,1372844,160062923,101965898,1747964,2882195,1165240,58859923,1196532,0,0,0
2021-03-28,N/A,US,Admin,USA,United States,30.9,17.9,0,161274828,1211905,672632,161274828,102638530,1746305,2909421,551419,59411342,1222183,0,0,0
2021-03-29,N/A,US,Admin,USA,United States,31.4,18.3,0,164117890,2843062,1610461,164117890,104248991,1746980,2977332,1275973,60687315,1289014,0,0,0
2021-03-30,N/A,US,Admin,USA,United States,32,18.8,0,167716886,3598996,2016519,167716886,106265510,1751440,3052943,1663370,62350685,1361827,0,0,0
2021-03-31,N/A,US,Admin,USA,United States,32.7,19.4,0,171894316,4177430,2415113,171894316,108680623,1780522,3140733,1941578,64292263,1435712,0,0,0
2021-04-01,N/A,US,Admin,USA,United States,33.5,20,0,176459343,4565027,2534667,176459343,111215290,1818409,3244068,2244367,66536630,1520623,0,0,0
2021-04-02,N/A,US,Admin,USA,United States,34.1,20.6,0,180121271,3661928,2061808,180121271,113277098,1812006,3219296,1817925,68354555,1522839,0,0,0
2021-04-03,N/A,US,Admin,USA,United States,34.5,20.9,0,182426261,2304990,1326954,182426261,114604052,1805451,3194763,1159882,69514437,1522073,0,0,0
2021-04-04,N/A,US,Admin,USA,United States,34.7,21,0,183190887,764626,438445,183190887,115042497,1771995,3130866,371775,69886212,1496410,0,0,0
2021-04-05,N/A,US,Admin,USA,United States,35.2,21.5,0,186300858,3109971,1737450,186300858,116779947,1790137,3168995,1603210,71489422,1543158,0,0,0
2021-04-06,N/A,US,Admin,USA,United States,35.9,22.2,0,190284838,3983980,2292320,190284838,119072267,1829537,3223993,2081939,73571361,1602954,0,0,0
2021-04-07,N/A,US,Admin,USA,United States,36.6,22.9,0,194646770,4361932,2564472,194646770,121636739,1850874,3250351,2305999,75877360,1655014,0,0,0
2021-04-08,N/A,US,Admin,USA,United States,37.4,23.6,0,199152897,4506127,2570322,199152897,124207061,1855967,3241936,2517872,78395232,1694086,0,0,0
2021-04-09,N/A,US,Admin,USA,United States,38.1,24.3,0,203476744,4323847,2442976,203476744,126650037,1910420,3336496,2439921,80835153,1782943,0,0,0
2021-04-10,N/A,US,Admin,USA,United States,38.7,24.8,0,206368215,2891471,1726890,206368215,128376927,1967554,3420279,1658130,82493283,1854121,0,0,0
2021-04-11,N/A,US,Admin,USA,United States,38.9,25.1,0,207770043,1401828,834279,207770043,129211206,2024101,3511308,801464,83294747,1915505,0,0,0
2021-04-12,N/A,US,Admin,USA,United States,39.4,25.6,0,210790459,3020416,1633944,210790459,130845150,2009315,3498514,1726240,85020987,1933081,0,0,0
2021-04-13,N/A,US,Admin,USA,United States,39.9,26.1,0,214269001,3478542,1741627,214269001,132586777,1930644,3426309,1719752,86740739,1881340,0,0,0
2021-04-14,N/A,US,Admin,USA,United States,40.5,26.7,0,217961229,3692228,1728791,217961229,134315568,1811261,3330637,1927539,88668278,1827274,0,0,0
2021-04-15,N/A,US,Admin,USA,United States,41,27.3,0,221704631,3743402,1752075,221704631,136067643,1694369,3221676,1951700,90619978,1746392,0,0,0
2021-04-16,N/A,US,Admin,USA,United States,41.5,27.9,0,225304157,3599526,1633309,225304157,137700952,1578702,3118202,1930522,92550500,1673621,0,0,0
2021-04-17,N/A,US,Admin,USA,United States,41.8,28.2,0,227665150,2360993,1163002,227665150,138863954,1498147,3042419,1177989,93728489,1605029,0,0,0
2021-04-18,N/A,US,Admin,USA,United States,42,28.4,0,228797702,1132552,538186,228797702,139402140,1455848,3003951,583159,94311648,1573843,0,0,0
2021-04-19,N/A,US,Admin,USA,United States,42.3,28.8,0,231375587,2577885,1082775,231375587,140484915,1377109,2940733,1465746,95777394,1536630,0,0,0
2021-04-20,N/A,US,Admin,USA,United States,42.7,29.4,0,234600705,3225118,1357119,234600705,141842034,1322180,2904529,1836414,97613808,1553296,0,0,0
2021-04-21,N/A,US,Admin,USA,United States,43.1,30,0,238068567,3467862,1379380,238068567,143221414,1272264,2872477,2051969,99665777,1571071,0,0,0
2021-04-22,N/A,US,Admin,USA,United States,43.6,30.6,0,241559128,3490561,1397724,241559128,144619138,1221642,2836357,2058604,101724381,1586343,0,0,0
2021-04-23,N/A,US,Admin,USA,United States,44,31.2,0,244848403,3289275,1350813,244848403,145969951,1181286,2792035,1907016,103631397,1582985,0,0,0
2021-04-24,N/A,US,Admin,USA,United States,44.3,31.6,0,247054933,2206530,1003895,247054933,146973846,1158556,2769969,1187415,104818812,1584332,0,0,0
2021-04-25,N/A,US,Admin,USA,United States,44.4,31.7,0,248047027,992094,489908,248047027,147463754,1151659,2749904,495952,105314764,1571874,0,0,0
2021-04-26,N/A,US,Admin,USA,United States,44.7,32.2,0,250432101,2385074,932119,250432101,148395873,1130137,2722359,1434866,106749630,1567462,0,0,0
2021-04-27,N/A,US,Admin,USA,United States,45,32.7,0,253322924,2890823,1104452,253322924,149500325,1094042,2674603,1793203,108542833,1561289,0,0,0
2021-04-28,N/A,US,Admin,USA,United States,45.4,33.3,0,256407085,3084161,1142015,256407085,150642340,1060132,2619788,1969160,110511993,1549459,0,0,0
2021-04-29,N/A,US,Admin,USA,United States,45.7,33.9,0,259449799,3042714,1109097,259449799,151751437,1018900,2555810,1982986,112494979,1538657,0,0,0
2021-04-30,N/A,US,Admin,USA,United States,46,34.4,0,262354736,2904937,1105939,262354736,152857376,983918,2500905,1854982,114349961,1531223,0,0,0
2021-05-01,N/A,US,Admin,USA,United States,46.3,34.8,0,264201053,1846317,705559,264201053,153562935,941298,2449446,1167559,115517520,1528387,0,0,0
2021-05-02,N/A,US,Admin,USA,United States,46.4,35,0,265079883,878830,325270,265079883,153888205,917779,2433265,585824,116103344,1541226,0,0,0
2021-05-03,N/A,US,Admin,USA,United States,46.5,35.4,0,267040900,1961017,636041,267040900,154524246,875482,2372686,1403163,117506507,1536697,0,0,0
2021-05-04,N/A,US,Admin,USA,United States,46.8,35.9,0,269537402,2496502,813354,269537402,155337600,833896,2316354,1757976,119264483,1531664,0,0,0
2021-05-05,N/A,US,Admin,USA,United States,47,36.5,0,272083333,2545931,812687,272083333,156150287,786850,2239464,1808558,121073041,1508721,0,0,0
2021-05-06,N/A,US,Admin,USA,United States,47.3,37,0,274600909,2517576,773665,274600909,156923952,738931,2164444,1819907,122892948,1485424,0,0,0
2021-05-07,N/A,US,Admin,USA,United States,47.5,37.6,0,277105797,2504888,788868,277105797,157712820,693635,2107294,1791323,124684271,1476330,0,0,0
2021-05-08,N/A,US,Admin,USA,United States,47.7,37.9,0,278640763,1534966,505496,278640763,158218316,665054,2062816,1088943,125773214,1465099,0,0,0
2021-05-09,N/A,US,Admin,USA,United States,47.7,38,0,279255783,615020,204698,279255783,158423014,647830,2025129,438069,126211283,1443991,0,0,0
2021-05-10,N/A,US,Admin,USA,United States,47.9,38.4,0,280859347,1603564,481677,280859347,158904691,625778,1974064,1176017,127387300,1411542,0,0,0
2021-05-11,N/A,US,Admin,USA,United States,48.1,38.8,0,282905631,2046284,656238,282905631,159560929,603333,1909747,1453032,128840332,1367978,0,0,0
2021-05-12,N/A,US,Admin,USA,United States,48.3,39.2,0,284919425,2013794,643461,284919425,160204390,579158,1833727,1439351,130279683,1315235,0,0,0
2021-05-13,N/A,US,Admin,USA,United States,48.5,39.7,0,287195292,2275867,926666,287195292,161131056,601015,1799198,1408762,131688445,1256500,0,0,0
2021-05-14,N/A,US,Admin,USA,United States,48.9,40.1,0,289645966,2450674,1091407,289645966,162222463,644235,1791453,1438826,133127271,1206143,0,0,0
2021-05-15,N/A,US,Admin,USA,United States,49.1,40.4,0,291492317,1846351,907948,291492317,163130411,701728,1835936,992489,134119760,1192364,0,0,0
2021-05-16,N/A,US,Admin,USA,United States,49.3,40.5,0,292425810,933493,477781,292425810,163608192,740740,1881432,486972,134606732,1199350,0,0,0
2021-05-17,N/A,US,Admin,USA,United States,49.5,40.8,0,294247403,1821593,886378,294247403,164494570,798554,1912579,1012144,135618876,1175939,0,0,0
2021-05-18,N/A,US,Admin,USA,United States,49.8,41.2,0,296319231,2071828,990742,296319231,165485312,846340,1916229,1166266,136785142,1134973,0,0,0
2021-05-19,N/A,US,Admin,USA,United States,50.1,41.6,0,298406508,2087277,987275,298406508,166472587,895457,1926726,1181079,137966221,1098077,0,0,0
2021-05-20,N/A,US,Admin,USA,United States,50.4,41.9,0,300425852,2019344,922731,300425852,167395318,894895,1890080,1178165,139144386,1065134,0,0,0
2021-05-21,N/A,US,Admin,USA,United States,50.7,42.3,0,302483207,2057355,932728,302483207,168328046,872226,1833892,1205213,140349599,1031761,0,0,0
2021-05-22,N/A,US,Admin,USA,United States,50.9,42.5,0,303932643,1449436,730637,303932643,169058683,846896,1777189,772527,141122126,1000338,0,0,0
2021-05-23,N/A,US,Admin,USA,United States,51,42.6,0,304590887,658244,339025,304590887,169397708,827074,1737868,347249,141469375,980378,0,0,0
2021-05-24,N/A,US,Admin,USA,United States,51.2,42.8,0,305910963,1320076,635947,305910963,170033655,791298,1666223,752125,142221500,943232,0,0,0
2021-05-25,N/A,US,Admin,USA,United States,51.4,43.1,0,307347865,1436902,668768,307347865,170702423,745302,1575519,839838,143061338,896599,0,0,0
2021-05-26,N/A,US,Admin,USA,United States,51.6,43.3,0,308781342,1433477,661447,308781342,171363870,698755,1482119,838610,143899948,847675,0,0,0
2021-05-27,N/A,US,Admin,USA,United States,51.8,43.6,0,310127617,1346275,614499,310127617,171978369,654722,1385966,798920,144698868,793497,0,0,0
2021-05-28,N/A,US,Admin,USA,United States,52,43.8,0,311456225,1328608,604497,311456225,172582866,607831,1281860,787017,145485885,733755,0,0,0
2021-05-29,N/A,US,Admin,USA,United States,52.1,43.9,0,312221413,765188,381446,312221413,172964312,557947,1184110,421569,145907454,683618,0,0,0
2021-05-30,N/A,US,Admin,USA,United States,52.2,44,0,312606525,385112,201263,312606525,173165575,538267,1145091,205258,146112712,663334,0,0,0
2021-05-31,N/A,US,Admin,USA,United States,52.2,44,0,312808627,202102,89379,312808627,173254954,460186,985381,122288,146235000,573357,0,0,0
2021-06-01,N/A,US,Admin,USA,United States,52.3,44.3,0,314075913,1267286,527951,314075913,173782905,440069,961150,784391,147019391,565436,0,0,0
2021-06-02,N/A,US,Admin,USA,United States,52.5,44.5,0,315192798,1116885,495509,315192798,174278414,416363,915922,681116,147700507,542937,0,0,0
2021-06-03,N/A,US,Admin,USA,United States,52.6,44.7,0,316439540,1246742,464071,316439540,174742485,394874,901703,838656,148539163,548614,0,0,0
2021-06-04,N/A,US,Admin,USA,United States,52.8,45,0,317841513,1401973,500919,317841513,175243404,380077,912184,959273,149498436,573222,0,0,0
2021-06-05,N/A,US,Admin,USA,United States,52.9,45.3,0,318913096,1071583,354360,318913096,175597764,376207,955955,751810,150250246,620399,0,0,0
2021-06-06,N/A,US,Admin,USA,United States,52.9,45.4,0,319429750,516654,171565,319429750,175769329,371965,974746,363548,150613794,643012,0,0,0
2021-06-07,N/A,US,Admin,USA,United States,53.1,45.6,0,320500767,1071017,373299,320500767,176142628,412525,1098877,740609,151354403,731343,0,0,0
2021-06-08,N/A,US,Admin,USA,United States,53.2,45.8,0,321676126,1175359,404772,321676126,176547400,394928,1085745,818819,152173222,736262,0,0,0
2021-06-09,N/A,US,Admin,USA,United States,53.3,46.1,0,322842543,1166417,391991,322842543,176939391,380140,1092821,823019,152996241,756533,0,0,0
2021-06-10,N/A,US,Admin,USA,United States,53.4,46.3,0,324013184,1170641,405350,324013184,177344741,371751,1081949,816799,153813040,753411,0,0,0
2021-06-11,N/A,US,Admin,USA,United States,53.5,46.6,0,325244435,1231251,428591,325244435,177773332,361418,1057560,854122,154667162,738389,0,0,0
2021-06-12,N/A,US,Admin,USA,United States,53.6,46.8,0,326137790,893355,281097,326137790,178054429,350952,1032099,643041,155310203,722851,0,0,0
2021-06-13,N/A,US,Admin,USA,United States,53.7,46.9,0,326530801,393011,113626,326530801,178168055,342675,1014436,296440,155606643,713264,0,0,0
2021-06-14,N/A,US,Admin,USA,United States,53.8,47.1,0,327443784,912983,332542,327443784,178500597,336853,991860,620105,156226748,696049,0,0,0
2021-06-15,N/A,US,Admin,USA,United States,53.9,47.3,0,328421712,977928,361255,328421712,178861852,330636,963655,661456,156888204,673569,0,0,0
2021-06-16,N/A,US,Admin,USA,United States,54,47.4,0,329366255,944543,358981,329366255,179220833,325920,931959,631387,157519591,646193,0,0,0
2021-06-17,N/A,US,Admin,USA,United States,54.1,47.6,0,330260386,894131,352128,330260386,179572961,318317,892457,591557,158111148,614015,0,0,0
2021-06-18,N/A,US,Admin,USA,United States,54.2,47.8,0,331181625,921239,368836,331181625,179941797,309781,848170,596790,158707938,577254,0,0,0
2021-06-19,N/A,US,Admin,USA,United States,54.3,47.9,0,331756999,575374,231603,331756999,180173400,302710,802744,370089,159078027,538261,0,0,0
2021-06-20,N/A,US,Admin,USA,United States,54.3,48,0,332033965,276966,112513,332033965,180285913,302551,786166,176164,159254191,521078,0,0,0
2021-06-21,N/A,US,Admin,USA,United States,54.4,48.1,0,332595116,561151,302194,332595116,180588107,298216,735905,293490,159547681,474419,0,0,0
2021-06-22,N/A,US,Admin,USA,United States,54.5,48.2,0,333351128,756012,325165,333351128,180913272,293060,704202,468955,160016636,446919,0,0,0
2021-06-23,N/A,US,Admin,USA,United States,54.6,48.3,0,334087529,736401,331536,334087529,181244808,289139,674468,442088,160458724,419876,0,0,0
2021-06-24,N/A,US,Admin,USA,United States,54.7,48.5,0,334787411,699882,319778,334787411,181564586,284518,646718,417579,160876303,395022,0,0,0
2021-06-25,N/A,US,Admin,USA,United States,54.8,48.6,0,335554669,767258,352175,335554669,181916761,282138,624721,452633,161328936,374428,0,0,0
2021-06-26,N/A,US,Admin,USA,United States,54.9,48.7,0,336054227,499558,225854,336054227,182142615,281316,613890,295260,161624196,363738,0,0,0
2021-06-27,N/A,US,Admin,USA,United States,54.9,48.7,0,336321789,267562,127362,336321789,182269977,283438,612546,150606,161774802,360087,0,0,0
2021-06-28,N/A,US,Admin,USA,United States,55,48.8,0,336876188,554399,276589,336876188,182546566,279780,611582,305258,162080060,361768,0,0,0
2021-06-29,N/A,US,Admin,USA,United States,55.1,48.9,0,337504598,628410,298806,337504598,182845372,276014,593353,358146,162438206,345939,0,0,0
2021-06-30,N/A,US,Admin,USA,United States,55.2,49,0,338136378,631780,308575,338136378,183153947,272734,578407,351114,162789320,332942,0,0,0
2021-07-01,N/A,US,Admin,USA,United States,55.3,49.1,0,338743248,606870,293517,338743248,183447464,268983,565120,334641,163123961,321094,0,0,0
2021-07-02,N/A,US,Admin,USA,United States,55.3,49.2,0,339363628,620380,306862,339363628,183754326,262509,544137,341357,163465318,305197,0,0,0
2021-07-03,N/A,US,Admin,USA,United States,55.4,49.3,0,339720939,357311,181980,339720939,183936306,256242,523816,188781,163654099,289986,0,0,0
2021-07-04,N/A,US,Admin,USA,United States,55.4,49.3,0,339771238,50299,27782,339771238,183964088,242016,492778,27329,163681428,272375,0,0,0
2021-07-05,N/A,US,Admin,USA,United States,55.5,49.4,0,340168291,397053,201885,340168291,184165973,231344,470300,208744,163890172,258587,0,0,0
2021-07-06,N/A,US,Admin,USA,United States,55.6,49.5,0,340752408,584117,274755,340752408,184440728,227908,463973,337335,164227507,255614,0,0,0
2021-07-07,N/A,US,Admin,USA,United States,55.6,49.6,0,341324584,572176,284457,341324584,184725185,224463,455458,320378,164547885,251224,0,0,0
2021-07-08,N/A,US,Admin,USA,United States,55.7,49.7,0,341892547,567963,291076,341892547,185016261,224114,449900,312742,164860627,248095,0,0,0
2021-07-09,N/A,US,Admin,USA,United States,55.8,49.8,0,342525720,633173,323364,342525720,185339625,226471,451727,345037,165205664,248621,0,0,0
2021-07-10,N/A,US,Admin,USA,United States,55.9,49.8,0,342926712,400992,211587,342926712,185551212,230701,457968,206772,165412436,251191,0,0,0
2021-07-11,N/A,US,Admin,USA,United States,55.9,49.9,0,343143500,216788,116939,343143500,185668151,243438,481752,107891,165520327,262700,0,0,0
2021-07-12,N/A,US,Admin,USA,United States,56,49.9,0,343664641,521141,275970,343664641,185944121,254021,499479,273589,165793916,271963,0,0,0
2021-07-13,N/A,US,Admin,USA,United States,56.1,50,0,344192029,527388,281972,344192029,186226093,255052,491374,271347,166065263,262537,0,0,0
2021-07-14,N/A,US,Admin,USA,United States,56.2,50.1,0,344724054,532025,284891,344724054,186510984,255114,485639,272266,166337529,255663,0,0,0
2021-07-15,N/A,US,Admin,USA,United States,56.3,50.2,0,345265812,541758,298968,345265812,186809952,256242,481895,268335,166605864,249320,0,0,0
2021-07-16,N/A,US,Admin,USA,United States,56.4,50.3,0,345891585,625773,348108,345891585,187158060,259776,480838,302801,166908665,243286,0,0,0
2021-07-17,N/A,US,Admin,USA,United States,56.4,50.3,0,346291651,400066,224166,346291651,187382226,261573,480706,188993,167097658,240746,0,0,0
2021-07-18,N/A,US,Admin,USA,United States,56.5,50.4,0,346525803,234152,135699,346525803,187517925,264253,483186,105587,167203245,240417,0,0,0
2021-07-19,N/A,US,Admin,USA,United States,56.6,50.4,0,347094861,569058,340511,347094861,187858436,273474,490031,252069,167455314,237343,0,0,0
2021-07-20,N/A,US,Admin,USA,United States,56.7,50.5,0,347699233,604372,372792,347699233,188231228,286448,501029,256035,167711349,235155,0,0,0
2021-07-21,N/A,US,Admin,USA,United States,56.8,50.6,0,348331364,632131,388343,348331364,188619571,301227,515330,267199,167978548,234431,0,0,0
2021-07-22,N/A,US,Admin,USA,United States,56.9,50.7,0,348981955,650591,417680,348981955,189037251,318186,530878,257573,168236121,232894,0,0,0
2021-07-23,N/A,US,Admin,USA,United States,57.1,50.8,0,349730240,748285,489032,349730240,189526283,338318,548379,287459,168523580,230702,0,0,0
2021-07-24,N/A,US,Admin,USA,United States,57.2,50.8,0,350193565,463325,302275,350193565,189828558,349476,557416,174138,168697718,228580,0,0,0
2021-07-25,N/A,US,Admin,USA,United States,57.2,50.8,0,350452731,259166,201924,350452731,190030482,358937,560990,63033,168760751,222501,0,0,0
2021-07-26,N/A,US,Admin,USA,United States,57.4,50.9,0,351096848,644117,448092,351096848,190478574,374305,571712,221155,168981906,218085,0,0,0
2021-07-27,N/A,US,Admin,USA,United States,57.5,51,0,351798603,701755,481020,351798603,190959594,389767,585624,251632,169233538,217456,0,0,0
2021-07-28,N/A,US,Admin,USA,United States,57.7,51.1,0,352519506,720903,491904,352519506,191451498,404561,598306,259067,169492605,216294,0,0,0
2021-07-29,N/A,US,Admin,USA,United States,57.8,51.1,0,353240472,720966,498165,353240472,191949663,416059,608360,253090,169745695,215653,0,0,0
2021-07-30,N/A,US,Admin,USA,United States,58,51.2,0,354076382,835910,576167,354076382,192525830,428507,620877,291174,170036869,216184,0,0,0
2021-07-31,N/A,US,Admin,USA,United States,58.1,51.3,0,354591663,515281,346658,354591663,192872488,434847,628300,180351,170217220,217072,0,0,0
2021-08-01,N/A,US,Admin,USA,United States,58.2,51.3,0,354920668,329005,226647,354920668,193099135,438379,638277,99510,170316730,222283,0,0,0
2021-08-02,N/A,US,Admin,USA,United States,58.3,51.4,0,355641391,720723,506750,355641391,193605885,446759,649220,238917,170555647,224820,0,0,0
2021-08-03,N/A,US,Admin,USA,United States,58.5,51.4,0,356404149,762758,538474,356404149,194144359,454966,657935,253920,170809567,225147,0,0,0
2021-08-04,N/A,US,Admin,USA,United States,58.6,51.5,0,357182707,778558,552799,357182707,194697158,463666,666172,255653,171065220,224659,0,0,0
2021-08-05,N/A,US,Admin,USA,United States,58.8,51.6,0,357975961,793254,560317,357975961,195257475,472545,676498,264884,171330104,226344,0,0,0
2021-08-06,N/A,US,Admin,USA,United States,59,51.7,0,358885170,909209,626523,358885170,195883998,479738,686970,311881,171641985,229302,0,0,0
2021-08-07,N/A,US,Admin,USA,United States,59.1,51.8,0,359443429,558259,381716,359443429,196265714,484747,693109,189911,171831896,230668,0,0,0
2021-08-08,N/A,US,Admin,USA,United States,59.2,51.8,0,359794006,350577,237691,359794006,196503405,486324,696191,117763,171949659,233276,0,0,0
2021-08-09,N/A,US,Admin,USA,United States,59.3,51.9,0,360577202,783196,520630,360577202,197024035,488307,705116,287101,172236760,240159,0,0,0
2021-08-10,N/A,US,Admin,USA,United States,59.5,52,0,361378498,801296,531239,361378498,197555274,487274,710621,295828,172532588,246146,0,0,0
2021-08-11,N/A,US,Admin,USA,United States,59.7,52.1,0,362148787,770289,499548,362148787,198054822,479666,709440,296319,172828907,251955,0,0,0
2021-08-12,N/A,US,Admin,USA,United States,59.8,52.2,0,362953402,804615,515203,362953402,198570025,473221,711063,314293,173143200,259014,0,0,0
2021-08-13,N/A,US,Admin,USA,United States,60,52.3,0,363902379,948977,581285,363902379,199151310,466759,716744,389799,173532999,270145,13801,13801,1972
2021-08-14,N/A,US,Admin,USA,United States,60.1,52.3,0,364528139,625760,362475,364528139,199513785,464010,726387,242682,173775681,277684,35860,49661,7094
2021-08-15,N/A,US,Admin,USA,United States,60.2,52.4,0,364928448,400309,212050,364928448,199725835,460347,733492,161775,173937456,283971,32800,82461,11780
2021-08-16,N/A,US,Admin,USA,United States,60.3,52.5,0.1,365800784,872336,465724,365800784,200191559,452503,746226,354702,174292158,293628,78684,161145,23021
2021-08-17,N/A,US,Admin,USA,United States,60.4,52.6,0.1,366726931,926147,491563,366726931,200683122,446835,764062,364341,174656499,303416,97606,258751,36964
2021-08-18,N/A,US,Admin,USA,United States,60.6,52.7,0.2,367682402,955471,488321,367682402,201171443,445232,790516,379711,175036210,315329,114067,372818,53260
2021-08-19,N/A,US,Admin,USA,United States,60.7,52.8,0.3,368629843,947441,481514,368629843,201652957,440419,810920,381872,175418082,324983,111580,484398,69200
2021-08-20,N/A,US,Admin,USA,United States,60.9,53,0.3,369739698,1109855,539466,369739698,202192423,434445,833903,479232,175897314,337759,119663,604061,84323
2021-08-21,N/A,US,Admin,USA,United States,61,53.1,0.4,370407193,667495,322460,370407193,202514883,428728,839865,297801,176195115,345633,60939,665000,87906
2021-08-22,N/A,US,Admin,USA,United States,61.1,53.1,0.4,370798799,391606,185888,370798799,202700771,424991,838622,180015,176375130,348239,31270,696270,87687
2021-08-23,N/A,US,Admin,USA,United States,61.2,53.2,0.4,371721602,922803,443499,371721602,203144270,421816,845831,405697,176780827,355524,95128,791398,90036
2021-08-24,N/A,US,Admin,USA,United States,61.3,53.4,0.5,372674351,952749,463718,372674351,203607988,417838,849631,415559,177196386,362841,98713,890111,90194
2021-08-25,N/A,US,Admin,USA,United States,61.5,53.5,0.6,373643625,969274,471396,373643625,204079384,415420,851603,423151,177619537,369047,101830,991941,88446
2021-08-26,N/A,US,Admin,USA,United States,61.6,53.6,0.6,374636706,993081,478557,374636706,204557941,414998,858123,433390,178052927,376406,109060,1101001,88086
2021-08-27,N/A,US,Admin,USA,United States,61.8,53.8,0.7,375810667,1173961,536820,375810667,205094761,414620,867281,540618,178593545,385176,124409,1225410,88764
2021-08-28,N/A,US,Admin,USA,United States,61.9,53.9,0.7,376523965,713298,320194,376523965,205414955,414296,873825,341218,178934763,391378,63436,1288846,89121
2021-08-29,N/A,US,Admin,USA,United States,61.9,54,0.7,376954796,430831,194183,376954796,205609138,415481,879428,205732,179140495,395052,35356,1324202,89705
2021-08-30,N/A,US,Admin,USA,United States,62.1,54.1,0.8,377882719,927923,418846,377882719,206027984,411959,880160,432004,179572499,398810,98478,1422680,90183
2021-08-31,N/A,US,Admin,USA,United States,62.2,54.2,0.9,378811202,928483,419732,378811202,206447716,405675,876693,421612,179994111,399675,108015,1530695,91512
2021-09-01,N/A,US,Admin,USA,United States,62.3,54.3,0.9,379750715,939513,428505,379750715,206876221,399548,872441,409420,180403531,397713,123106,1653801,94551
2021-09-02,N/A,US,Admin,USA,United States,62.4,54.5,1,380647791,897076,405325,380647791,207281546,389086,858726,401558,180805089,393166,113086,1766887,95127
2021-09-03,N/A,US,Admin,USA,United States,62.6,54.6,1,381690253,1042462,455758,381690253,207737304,377506,839941,490629,181295718,386025,118013,1884900,94213
2021-09-04,N/A,US,Admin,USA,United States,62.6,54.7,1.1,382251176,560923,246631,382251176,207983935,366997,818173,277912,181573630,376981,44225,1929125,91468
2021-09-05,N/A,US,Admin,USA,United States,62.7,54.7,1.1,382617691,366515,168217,382617691,208152152,363288,808985,173676,181747306,372402,27482,1956607,90344
2021-09-06,N/A,US,Admin,USA,United States,62.7,54.8,1.1,382795287,177596,82403,382795287,208234555,315224,701795,87303,181834609,323159,11875,1968482,77972
2021-09-07,N/A,US,Admin,USA,United States,62.8,54.9,1.1,383704462,909175,354986,383704462,208589541,305975,699037,480289,182314898,331541,91516,2059998,75615
2021-09-08,N/A,US,Admin,USA,United States,62.9,55,1.2,384549398,844936,366656,384549398,208956197,297139,685526,402285,182717183,330522,95214,2155212,71630
2021-09-09,N/A,US,Admin,USA,United States,63,55.2,1.2,385396479,847081,372967,385396479,209329164,292517,678384,397794,183114977,329984,96771,2251983,69299
2021-09-10,N/A,US,Admin,USA,United States,63.2,55.3,1.3,386430457,1033978,450153,386430457,209779317,291716,677172,500549,183615526,331401,106123,2358106,67601
2021-09-11,N/A,US,Admin,USA,United States,63.3,55.4,1.3,387027425,596968,258428,387027425,210037745,293401,682321,300613,183916139,334644,48567,2406673,68221
2021-09-12,N/A,US,Admin,USA,United States,63.3,55.4,1.3,387377534,350109,157065,387377534,210194810,291808,679978,173858,184089997,334670,22955,2429628,67574
2021-09-13,N/A,US,Admin,USA,United States,63.4,55.6,1.4,388158998,781464,338080,388158998,210532890,328334,766244,384552,184474549,377134,75500,2505128,76664
2021-09-14,N/A,US,Admin,USA,United States,63.5,55.7,1.4,388908696,749698,316318,388908696,210849208,322810,743462,378826,184853375,362640,74199,2579327,74190
2021-09-15,N/A,US,Admin,USA,United States,63.6,55.8,1.4,389670603,761907,312908,389670603,211162116,315131,731601,390213,185243588,360915,78134,2657461,71750
2021-09-16,N/A,US,Admin,USA,United States,63.7,55.9,1.5,390430457,759854,311126,390430457,211473242,306297,719140,393031,185636619,360235,76750,2734211,68890
2021-09-17,N/A,US,Admin,USA,United States,63.8,56.1,1.5,391332336,901879,351412,391332336,211824654,292191,700268,482654,186119273,357678,89350,2823561,66494
2021-09-18,N/A,US,Admin,USA,United States,63.9,56.1,1.5,391853663,521327,205313,391853663,212029967,284603,689463,276365,186395638,354214,48151,2871712,66434
2021-09-19,N/A,US,Admin,USA,United States,63.9,56.2,1.6,392158958,305295,119464,392158958,212149431,279232,683061,165697,186561335,353048,23213,2894925,66471
2021-09-20,N/A,US,Admin,USA,United States,64,56.3,1.6,392847071,688113,265945,392847071,212415376,268927,669725,352553,186913888,348477,85297,2980222,67871
2021-09-21,N/A,US,Admin,USA,United States,64.1,56.4,1.6,393522613,675542,261608,393522613,212676984,261111,659131,344062,187257950,343511,88373,3068595,69895
2021-09-22,N/A,US,Admin,USA,United States,64.1,56.5,1.7,394186436,663823,254056,394186436,212931040,252703,645119,336921,187594871,335898,85081,3153676,70888
2021-09-23,N/A,US,Admin,USA,United States,64.2,56.6,1.7,394859993,673557,255599,394859993,213186639,244771,632791,329705,187924576,326851,101553,3255229,74431
2021-09-24,N/A,US,Admin,USA,United States,64.3,56.7,1.9,395841614,981621,321684,395841614,213508323,240524,644183,414891,188339467,317171,254951,3510180,98088
2021-09-25,N/A,US,Admin,USA,United States,64.4,56.8,2,396511280,669666,203102,396511280,213711425,240208,665374,229694,188569161,310503,239208,3749388,125382
2021-09-26,N/A,US,Admin,USA,United States,64.4,56.8,2.1,396919090,407810,120204,396919090,213831629,240314,680019,146177,188715338,307715,142083,3891471,142364
2021-09-27,N/A,US,Admin,USA,United States,64.5,56.9,2.3,397943483,1024393,299573,397943483,214131202,245118,728059,224314,188939652,289395,504274,4395745,202218
2021-09-28,N/A,US,Admin,USA,United States,64.6,57,2.6,399069851,1126368,291791,399069851,214422993,249430,792463,305028,189244680,283819,535493,4931238,266092
2021-09-29,N/A,US,Admin,USA,United States,64.7,57.1,2.9,400203796,1133945,289979,400203796,214712972,254562,859623,312983,189557663,280399,538914,5470152,330925
2021-09-30,N/A,US,Admin,USA,United States,64.8,57.2,3.2,401358418,1154622,290713,401358418,215003685,259578,928346,321323,189878986,279201,552470,6022622,395342
2021-10-01,N/A,US,Admin,USA,United States,64.9,57.3,3.5,402665607,1307189,316658,402665607,215320343,258860,974856,380179,190259165,274243,616779,6639401,447032
2021-10-02,N/A,US,Admin,USA,United States,64.9,57.4,3.6,403292712,627105,174170,403292712,215494513,254727,968776,207668,190466833,271096,249806,6889207,448546
2021-10-03,N/A,US,Admin,USA,United States,64.9,57.4,3.7,403657448,364736,106535,403657448,215601048,252774,962623,130658,190597491,268879,128846,7018053,446655
2021-10-04,N/A,US,Admin,USA,United States,65,57.5,3.9,404634408,976960,247964,404634408,215849012,245401,955846,257425,190854916,273609,478993,7497046,443043
2021-10-05,N/A,US,Admin,USA,United States,65.1,57.6,4.2,405643550,1009142,245090,405643550,216094102,238730,939100,257420,191112336,266808,515259,8012305,440152
2021-10-06,N/A,US,Admin,USA,United States,65.2,57.6,4.5,406667569,1024019,248901,406667569,216343003,232862,923396,259485,191371821,259165,524247,8536552,438057
2021-10-07,N/A,US,Admin,USA,United States,65.2,57.7,4.7,407676248,1008679,251210,407676248,216594213,227218,902547,256408,191628229,249892,511119,9047671,432150
2021-10-08,N/A,US,Admin,USA,United States,65.3,57.8,5,408812612,1136364,283772,408812612,216877985,222520,878144,310844,191939073,239987,552109,9599780,422911
2021-10-09,N/A,US,Admin,USA,United States,65.4,57.9,5.1,409346430,533818,147814,409346430,217025799,218755,864817,168570,192107643,234401,222179,9821959,418965
2021-10-10,N/A,US,Admin,USA,United States,65.4,57.9,5.2,409659474,313044,93189,409659474,217118988,216849,857432,105112,192212755,230752,115873,9937832,417111
2021-10-11,N/A,US,Admin,USA,United States,65.5,58,5.4,410510055,850581,226194,410510055,217345182,213739,839378,221504,192434259,225620,410446,10348278,407319
2021-10-12,N/A,US,Admin,USA,United States,65.5,58,5.6,411430582,920527,229297,411430582,217574479,211482,826719,234672,192668931,222371,466298,10814576,400324
2021-10-13,N/A,US,Admin,USA,United States,65.6,58.1,5.8,412331347,900765,228043,412331347,217802522,208503,809111,229651,192898582,218109,454438,11269014,390352
2021-10-14,N/A,US,Admin,USA,United States,65.7,58.2,6.1,413236677,905330,226535,413236677,218029057,204978,794347,229803,193128385,214308,461039,11730053,383197
2021-10-15,N/A,US,Admin,USA,United States,65.7,58.3,6.3,414281941,1045264,262193,414281941,218291250,201895,781333,278214,193406599,209647,517019,12247072,378185
2021-10-16,N/A,US,Admin,USA,United States,65.8,58.3,6.4,414771584,489643,141077,414771584,218432327,200933,775022,145156,193551755,206302,209172,12456244,376326
2021-10-17,N/A,US,Admin,USA,United States,65.8,58.3,6.5,415040021,268437,83945,415040021,218516272,199612,768650,84472,193636227,203353,101646,12557890,374294
2021-10-18,N/A,US,Admin,USA,United States,65.9,58.4,6.7,415866450,826429,223677,415866450,218739949,199252,765199,211699,193847926,201952,400871,12958761,372926
2021-10-19,N/A,US,Admin,USA,United States,65.9,58.4,6.9,416683499,817049,202462,416683499,218942411,195419,750417,193177,194041103,196025,431189,13389950,367911
2021-10-20,N/A,US,Admin,USA,United States,66,58.5,7.1,417514040,830541,203661,417514040,219146072,191936,740385,194973,194236076,191071,442118,13832068,366151
2021-10-21,N/A,US,Admin,USA,United States,66.1,58.6,7.3,418366469,852429,207198,418366469,219353270,189173,732827,197597,194433673,186470,457524,14289592,365648
2021-10-22,N/A,US,Admin,USA,United States,66.2,58.6,7.8,419736349,1369880,292736,419736349,219646006,193537,779201,246435,194680108,181930,833237,15122829,410822
2021-10-23,N/A,US,Admin,USA,United States,66.2,58.7,8,420561261,824912,176309,420561261,219822315,198570,827097,133905,194814013,180323,513647,15636476,454319
2021-10-24,N/A,US,Admin,USA,United States,66.2,58.7,8.2,421031806,470545,108055,421031806,219930370,202014,855969,80526,194894539,179759,280684,15917160,479896
2021-10-25,N/A,US,Admin,USA,United States,66.3,58.8,8.7,422549356,1517550,302896,422549356,220233266,213331,954701,204777,195099316,178770,1006565,16923725,566423
2021-10-26,N/A,US,Admin,USA,United States,66.4,58.8,9.2,424099960,1550604,298181,424099960,220531447,227005,1059494,201627,195300943,179977,1052762,17976487,655220
2021-10-27,N/A,US,Admin,USA,United States,66.5,58.9,9.8,425712550,1612590,307353,425712550,220838800,241818,1171216,207632,195508575,181786,1101404,19077891,749403
2021-10-28,N/A,US,Admin,USA,United States,66.6,58.9,10.3,427311050,1598500,297805,427311050,221136605,254762,1277797,209144,195717719,183435,1097562,20175453,840837
2021-10-29,N/A,US,Admin,USA,United States,66.7,59,10.9,429086359,1775309,327084,429086359,221463689,259669,1335716,238427,195956146,182291,1215837,21391290,895494
2021-10-30,N/A,US,Admin,USA,United States,66.8,59.1,11.2,429902123,815764,167155,429902123,221630844,258361,1334409,119447,196075593,180226,533622,21924912,898348
2021-10-31,N/A,US,Admin,USA,United States,66.8,59.1,11.3,430337622,435499,100369,430337622,221731213,257263,1329402,70675,196146268,178818,265701,22190613,896208
2021-11-01,N/A,US,Admin,USA,United States,66.9,59.1,11.8,431794563,1456941,284900,431794563,222016113,254692,1320744,195789,196342057,177534,978465,23169078,892193
2021-11-02,N/A,US,Admin,USA,United States,67,59.2,12.3,433288377,1493814,284322,433288377,222300435,252713,1312631,188839,196530896,175708,1029806,24198884,888914
2021-11-03,N/A,US,Admin,USA,United States,67.1,59.3,12.8,434843864,1555487,312127,434843864,222612562,253395,1304473,192477,196723373,173543,1060766,25259650,883108
2021-11-04,N/A,US,Admin,USA,United States,67.2,59.3,13.4,436472856,1628992,351638,436472856,222964200,261085,1308829,195433,196918806,171584,1092749,26352399,882421
2021-11-05,N/A,US,Admin,USA,United States,67.3,59.4,14,438377009,1904153,455282,438377009,223419482,279399,1327236,230145,197148951,170401,1230098,27582497,884458
2021-11-06,N/A,US,Admin,USA,United States,67.4,59.4,14.3,439407474,1030465,390015,439407474,223809497,311236,1357907,117992,197266943,170193,528438,28110935,883718
2021-11-07,N/A,US,Admin,USA,United States,67.5,59.4,14.4,439960248,552774,228118,439960248,224037615,329486,1374661,70670,197337613,170192,258131,28369066,882636
2021-11-08,N/A,US,Admin,USA,United States,67.6,59.5,14.8,441416953,1456705,472026,441416953,224509641,356218,1374627,173427,197511040,166998,820903,29189969,860127
2021-11-09,N/A,US,Admin,USA,United States,67.8,59.5,15.2,443046642,1629689,523358,443046642,225032999,390366,1394038,166606,197677646,163821,946613,30136582,848243
2021-11-10,N/A,US,Admin,USA,United States,68,59.6,15.7,444807044,1760402,574393,444807044,225607392,427833,1423311,170816,197848462,160727,1021706,31158288,842663
2021-11-11,N/A,US,Admin,USA,United States,68.1,59.6,16.2,446403378,1596334,550227,446403378,226157619,456203,1418646,153996,198002458,154807,898016,32056304,814844
2021-11-12,N/A,US,Admin,USA,United States,68.3,59.7,16.8,448387305,1983927,640493,448387305,226798112,482661,1430042,199839,198202297,150478,1152046,33208350,803693
2021-11-13,N/A,US,Admin,USA,United States,68.5,59.7,17,449558654,1171349,535465,449558654,227333577,503440,1450169,103142,198305439,148357,535529,33743879,804706
2021-11-14,N/A,US,Admin,USA,United States,68.5,59.7,17.2,450135780,577126,240294,450135780,227573871,505179,1453647,60741,198366180,146938,278438,34022317,807607
2021-11-15,N/A,US,Admin,USA,United States,68.7,59.8,17.6,451680723,1544943,461660,451680723,228035531,503699,1466253,167646,198533826,146112,922513,34944830,822123
2021-11-16,N/A,US,Admin,USA,United States,68.8,59.8,18.1,453356011,1675288,489419,453356011,228524950,498850,1472767,167841,198701667,146289,1026489,35971319,833534
2021-11-17,N/A,US,Admin,USA,United States,69,59.9,18.6,455109089,1753078,508010,455109089,229032960,489367,1471721,173285,198874952,146641,1079781,37051100,841830
2021-11-18,N/A,US,Admin,USA,United States,69.1,60,19.2,456889964,1780875,508309,456889964,229541269,483379,1498084,171988,199046940,149212,1109209,38160309,872001
2021-11-19,N/A,US,Admin,USA,United States,69.3,60,19.8,458955239,2065275,584343,458955239,230125612,475357,1509705,195852,199242792,148642,1293399,39453708,892194
2021-11-20,N/A,US,Admin,USA,United States,69.5,60,20.1,460184025,1228786,460111,460184025,230585723,464592,1517910,101201,199343993,148365,671456,40125164,911612
2021-11-21,N/A,US,Admin,USA,United States,69.5,60.1,20.3,460825886,641861,206550,460825886,230792273,459772,1527158,60274,199404267,148298,376409,40501573,925608
2021-11-22,N/A,US,Admin,USA,United States,69.7,60.1,20.9,462631282,1805396,490676,462631282,231282949,463917,1564366,172044,199576311,148926,1148822,41650395,957938
2021-11-23,N/A,US,Admin,USA,United States,69.8,60.2,21.4,464413443,1782161,491779,464413443,231774728,464254,1579633,166304,199742615,148707,1131259,42781654,972905
2021-11-24,N/A,US,Admin,USA,United States,69.9,60.2,21.8,465791613,1378170,403178,465791613,232177906,449278,1526075,155018,199897633,146097,828020,43609674,936939
2021-11-25,N/A,US,Admin,USA,United States,69.9,60.2,21.8,465819274,27661,8894,465819274,232186800,377933,1275616,5144,199902777,122262,13528,43623202,780413
2021-11-26,N/A,US,Admin,USA,United States,70,60.3,22.2,467021718,1202444,312149,467021718,232498949,339048,1152354,176933,200079710,119560,717348,44340550,698120
2021-11-27,N/A,US,Admin,USA,United States,70.1,60.3,22.4,467912465,890747,220533,467912465,232719482,304823,1104063,199424,200279134,133592,473879,44814429,669895
2021-11-28,N/A,US,Admin,USA,United States,70.1,60.4,22.5,468501041,588576,142508,468501041,232861990,295674,1096451,147766,200426900,146090,299969,45114398,658975
2021-11-29,N/A,US,Admin,USA,United States,70.2,60.5,22.9,470155875,1654834,355805,470155875,233217795,276407,1074942,361566,200788466,173165,945533,46059931,629934
2021-11-30,N/A,US,Admin,USA,United States,70.4,60.6,23.5,472069764,1913889,406517,472069764,233624312,264226,1093760,391857,201180323,205387,1124627,47184558,628986
2021-12-01,N/A,US,Admin,USA,United States,70.5,60.7,24,474211605,2141841,459990,474211605,234084302,272342,1202856,409747,201590070,241777,1277109,48461667,693142
2021-12-02,N/A,US,Admin,USA,United States,70.6,60.8,24.6,476361082,2149477,448192,476361082,234532494,335099,1505973,394665,201984735,297423,1314920,49776587,879055
2021-12-03,N/A,US,Admin,USA,United States,70.8,61,25.3,478784900,2423818,487501,478784900,235019995,360149,1680455,492081,202476816,342444,1452583,51229170,984089
2021-12-04,N/A,US,Admin,USA,United States,70.9,61.1,25.6,480258380,1473480,301561,480258380,235321556,371725,1763702,452458,202929274,378591,722872,51952042,1019659
2021-12-05,N/A,US,Admin,USA,United States,70.9,61.2,25.8,480984759,726379,165754,480984759,235487310,375046,1783388,189579,203118853,384565,373206,52325248,1030121
2021-12-06,N/A,US,Admin,USA,United States,71,61.3,26.3,482804428,1819669,390498,482804428,235877808,380002,1806936,325925,203444778,379473,1108003,53433251,1053331
2021-12-07,N/A,US,Admin,USA,United States,71.2,61.4,26.8,484702043,1897615,402890,484702043,236280698,379484,1804611,341880,203786658,372334,1158021,54591272,1058102
2021-12-08,N/A,US,Admin,USA,United States,71.3,61.5,27.3,486614198,1912155,407633,486614198,236688331,372004,1771799,353138,204139796,364247,1157908,55749180,1041073
2021-12-09,N/A,US,Admin,USA,United States,71.4,61.6,27.8,488523330,1909132,404687,488523330,237093018,365789,1737464,340374,204480170,356491,1170481,56919661,1020439
2021-12-10,N/A,US,Admin,USA,United States,71.5,61.7,28.4,490617228,2093898,424375,490617228,237517393,356771,1690333,397366,204877536,342960,1277338,58196999,995404
2021-12-11,N/A,US,Admin,USA,United States,71.6,61.8,28.7,491868472,1251244,267190,491868472,237784583,351861,1658585,336922,205214458,326455,650221,58847220,985025
2021-12-12,N/A,US,Admin,USA,United States,71.7,61.8,28.8,492495867,627395,151594,492495867,237936177,349838,1644444,129763,205344221,317910,348495,59195715,981495
2021-12-13,N/A,US,Admin,USA,United States,71.8,61.9,29.3,494102073,1606206,347634,494102073,238283811,343715,1613949,279333,205623554,311254,984999,60180714,963923
2021-12-14,N/A,US,Admin,USA,United States,71.9,62,29.7,495804676,1702603,367034,495804676,238650845,338592,1586090,286773,205910327,303381,1056052,61236766,949356
2021-12-15,N/A,US,Admin,USA,United States,72,62.1,30.2,497508371,1703695,378506,497508371,239029351,334431,1556310,261110,206171437,290234,1070496,62307262,936869
2021-12-16,N/A,US,Admin,USA,United States,72.1,62.1,30.7,499183943,1675572,390022,499183943,239419373,332336,1522945,170147,206341584,265916,1122149,63429411,929964
2021-12-17,N/A,US,Admin,USA,United States,72.2,62.2,31.3,501102363,1918420,433136,501102363,239852509,333588,1497876,252643,206594227,245242,1235004,64664415,923917
2021-12-18,N/A,US,Admin,USA,United States,72.3,62.3,31.6,502218281,1115918,288234,502218281,240140743,336594,1478544,163187,206757414,220422,665421,65329836,926088
2021-12-19,N/A,US,Admin,USA,United States,72.4,62.3,31.8,502855507,637226,169371,502855507,240310114,339134,1479949,81800,206839214,213570,386353,65716189,931496
2021-12-20,N/A,US,Admin,USA,United States,72.5,62.4,32.3,504682988,1827481,442268,504682988,240752382,352653,1511559,226922,207066136,206083,1159637,66875826,956445
2021-12-21,N/A,US,Admin,USA,United States,72.7,62.4,32.9,506638625,1955637,467415,506638625,241219797,366993,1547707,242751,207308887,199794,1245901,68121727,983566
2021-12-22,N/A,US,Admin,USA,United States,72.8,62.5,33.4,508486031,1847406,447160,508486031,241666957,376801,1568237,238933,207547820,196626,1163267,69284994,996819
2021-12-23,N/A,US,Admin,USA,United States,72.9,62.6,33.8,509935104,1449073,368529,509935104,242035486,373730,1535880,177995,207725815,197747,904353,70189347,965705
2021-12-24,N/A,US,Admin,USA,United States,72.9,62.6,33.9,510312821,377717,103522,510312821,242139008,326643,1315780,56597,207782412,169741,219073,70408420,820572
2021-12-25,N/A,US,Admin,USA,United States,72.9,62.6,33.9,510319196,6375,2079,510319196,242141087,285763,1157274,918,207783330,146559,3316,70411736,725986
2021-12-26,N/A,US,Admin,USA,United States,73,62.6,34,510796069,476873,132345,510796069,242273432,280474,1134366,83308,207866638,146775,261685,70673421,708176
2021-12-27,N/A,US,Admin,USA,United States,73.1,62.7,34.4,512311438,1515369,395476,512311438,242668908,273789,1089779,229841,208096479,147192,892256,71565677,669979
2021-12-28,N/A,US,Admin,USA,United States,73.2,62.8,34.8,513986157,1674719,435175,513986157,243104083,269184,1049647,241240,208337719,146976,1000579,72566256,634933
2021-12-29,N/A,US,Admin,USA,United States,73.4,62.8,35.3,515643596,1657439,436167,515643596,243540250,267613,1022509,236722,208574441,146660,986914,73553170,609739
2021-12-30,N/A,US,Admin,USA,United States,73.5,62.9,35.7,517157494,1513898,402998,517157494,243943248,272537,1031770,214259,208788700,151841,899242,74452412,609009
2021-12-31,N/A,US,Admin,USA,United States,73.5,62.9,35.8,517760360,602866,161656,517760360,244104904,280842,1063934,93187,208881887,157068,349016,74801428,627573
2022-01-01,N/A,US,Admin,USA,United States,73.5,62.9,35.8,517862892,102532,33117,517862892,244138021,285276,1077671,16091,208897978,159235,52241,74853669,634562
2022-01-02,N/A,US,Admin,USA,United States,73.6,62.9,35.9,518356322,493430,137208,518356322,244275229,285971,1080036,90337,208988315,160240,266707,75120376,635279
2022-01-03,N/A,US,Admin,USA,United States,73.7,63,36.2,519583148,1226826,342713,519583148,244617942,278433,1038816,196545,209184860,155483,691148,75811524,606550
2022-01-04,N/A,US,Admin,USA,United States,73.8,63.1,36.6,520980956,1397808,374360,520980956,244992302,269746,999257,214100,209398960,151606,813295,76624819,579795
2022-01-05,N/A,US,Admin,USA,United States,73.9,63.1,37,522409452,1428496,381491,522409452,245373793,261935,966551,212581,209611541,148157,838682,77463501,558619
2022-01-06,N/A,US,Admin,USA,United States,74,63.2,37.3,523847381,1437929,371529,523847381,245745322,257439,955698,212033,209823574,147839,858164,78321665,552750
2022-01-07,N/A,US,Admin,USA,United States,74.1,63.3,37.7,525464238,1616857,400854,525464238,246146176,291610,1100554,244792,210068366,169497,974626,79296291,642123
2022-01-08,N/A,US,Admin,USA,United States,74.2,63.3,38,526499446,1035208,275593,526499446,246421769,326250,1233793,174282,210242648,192096,586823,79883114,718492
2022-01-09,N/A,US,Admin,USA,United States,74.3,63.3,38.1,526991125,491679,142513,526991125,246564282,327008,1233543,74680,210317328,189859,275608,80158722,719764
2022-01-10,N/A,US,Admin,USA,United States,74.4,63.4,38.4,528232115,1240990,332346,528232115,246896628,325527,1235567,189883,210507211,188907,722400,80881122,724228
2022-01-11,N/A,US,Admin,USA,United States,74.5,63.5,38.7,529521493,1289378,340919,529521493,247237547,320749,1220077,201310,210708521,187080,750342,81631464,715235
2022-01-12,N/A,US,Admin,USA,United States,74.6,63.5,39.1,530811630,1290137,342506,530811630,247580053,315180,1200311,199818,210908339,185257,751251,82382715,702745
2022-01-13,N/A,US,Admin,USA,United States,74.7,63.6,39.4,532080648,1269018,338747,532080648,247918800,310497,1176181,188402,211096741,181881,744543,83127258,686513
2022-01-14,N/A,US,Admin,USA,United States,74.8,63.6,39.8,533529147,1448499,381181,533529147,248299981,307686,1152130,174665,211271406,171863,893148,84020406,674874
2022-01-15,N/A,US,Admin,USA,United States,74.9,63.7,40,534310312,781165,227984,534310312,248527965,300885,1115838,87402,211358808,159451,465309,84485715,657514
2022-01-16,N/A,US,Admin,USA,United States,74.9,63.7,40.1,534697831,387519,107170,534697831,248635135,295836,1100958,57815,211416623,157042,222662,84708377,649951
2022-01-17,N/A,US,Admin,USA,United States,75,63.7,40.3,535516771,818940,218209,535516771,248853344,279531,1040665,140591,211557214,150000,459807,85168184,612437
2022-01-18,N/A,US,Admin,USA,United States,75,63.8,40.5,536500863,984092,256518,536500863,249109862,267474,997053,187700,211744914,148056,539410,85707594,582304
2022-01-19,N/A,US,Admin,USA,United States,75.1,63.8,40.7,537465763,964900,255362,537465763,249365224,255024,950590,186047,211930961,146089,522721,86230315,549657
2022-01-20,N/A,US,Admin,USA,United States,75.2,63.9,40.9,538387216,921453,244753,538387216,249609977,241597,900938,175512,212106473,144247,499935,86730250,514713
2022-01-21,N/A,US,Admin,USA,United States,75.3,63.9,41.2,539448901,1061685,282112,539448901,249892089,227444,845679,160295,212266768,142195,617569,87347819,475345
2022-01-22,N/A,US,Admin,USA,United States,75.3,64,41.3,540061478,612577,175153,540061478,250067242,219897,821595,82489,212349257,141493,353464,87701283,459367
2022-01-23,N/A,US,Admin,USA,United States,75.3,64,41.4,540390338,328860,93034,540390338,250160276,217877,813215,63983,212413240,142374,171651,87872934,452080
2022-01-24,N/A,US,Admin,USA,United States,75.4,64,41.5,541176650,786312,208406,541176650,250368682,216477,808554,159592,212572832,145088,416676,88289610,445918
2022-01-25,N/A,US,Admin,USA,United States,75.5,64.1,41.7,541968083,791433,207870,541968083,250576552,209527,781031,174397,212747229,143188,407432,88697042,427064
2022-01-26,N/A,US,Admin,USA,United States,75.5,64.1,41.8,542747072,778989,204233,542747072,250780785,202223,754473,177804,212925033,142010,395337,89092379,408866
2022-01-27,N/A,US,Admin,USA,United States,75.6,64.2,42,543524918,777846,202565,543524918,250983350,196196,733957,173856,213098889,141774,398820,89491199,394421
2022-01-28,N/A,US,Admin,USA,United States,75.7,64.2,42.2,544464255,939337,233380,544464255,251216730,189234,716479,208353,213307242,148639,493377,89984576,376680
2022-01-29,N/A,US,Admin,USA,United States,75.7,64.3,42.3,544929473,465218,123774,544929473,251340504,181895,695428,111323,213418565,152758,228247,90212823,358791
2022-01-30,N/A,US,Admin,USA,United States,75.7,64.3,42.3,545191841,262368,73502,545191841,251414006,179104,685929,66785,213485350,153159,121369,90334192,351608
2022-01-31,N/A,US,Admin,USA,United States,75.8,64.3,42.4,545813380,621539,163027,545813380,251577033,172622,662390,157393,213642743,152844,298599,90632791,334740
2022-02-01,N/A,US,Admin,USA,United States,75.8,64.4,42.5,546413087,599707,152012,546413087,251729045,164642,635001,157989,213800732,150500,286052,90918843,317400
2022-02-02,N/A,US,Admin,USA,United States,75.9,64.4,42.6,546973738,560651,146316,546973738,251875361,156368,603809,152865,213953597,146938,259368,91178211,297976
2022-02-03,N/A,US,Admin,USA,United States,75.9,64.5,42.7,547483303,509565,130747,547483303,252006108,146108,565484,138556,214092153,141895,237662,91415873,274953
2022-02-04,N/A,US,Admin,USA,United States,76,64.5,42.8,548128683,645380,156362,548128683,252162470,135106,523490,182458,214274611,138196,302897,91718770,247742
2022-02-05,N/A,US,Admin,USA,United States,76,64.6,42.9,548560992,432309,110761,548560992,252273231,133247,518788,131350,214405961,141057,187895,91906665,241977
2022-02-06,N/A,US,Admin,USA,United States,76,64.6,42.9,548771023,210031,59870,548771023,252333101,131299,511312,59816,214465777,140061,89382,91996047,237408
2022-02-07,N/A,US,Admin,USA,United States,76,64.6,43,549245472,474449,129522,549245472,252462623,126513,490299,130443,214596220,136211,210727,92206774,224855
2022-02-08,N/A,US,Admin,USA,United States,76.1,64.7,43,549737691,492219,126793,549737691,252589416,122910,474943,143937,214740157,134204,217228,92424002,215023
2022-02-09,N/A,US,Admin,USA,United States,76.1,64.7,43.1,550239536,501845,131255,550239536,252720671,120759,466543,143742,214883899,132900,223042,92647044,209833
2022-02-10,N/A,US,Admin,USA,United States,76.2,64.8,43.2,550737891,498355,129150,550737891,252849821,120530,464941,138088,215021987,132833,226724,92873768,208271
2022-02-11,N/A,US,Admin,USA,United States,76.2,64.8,43.3,551350454,612563,153230,551350454,253003051,120083,460253,171848,215193835,131318,282126,93155894,205303
2022-02-12,N/A,US,Admin,USA,United States,76.2,64.8,43.3,551692795,342341,92479,551692795,253095530,117471,447400,101241,215295076,127016,145877,93301771,199301
2022-02-13,N/A,US,Admin,USA,United States,76.2,64.9,43.4,551843704,150909,43597,551843704,253139127,115147,438954,45540,215340616,124977,60275,93362046,195143
2022-02-14,N/A,US,Admin,USA,United States,76.3,64.9,43.4,552178875,335171,89157,552178875,253228284,109380,419058,95990,215436606,120055,145978,93508024,185893
2022-02-15,N/A,US,Admin,USA,United States,76.3,64.9,43.5,552572770,393895,101014,552572770,253329298,105697,405011,113834,215550440,115755,174028,93682052,179721
2022-02-16,N/A,US,Admin,USA,United States,76.3,65,43.5,552977574,404804,103216,552977574,253432514,101692,391148,114867,215665307,111630,181856,93863908,173838
2022-02-17,N/A,US,Admin,USA,United States,76.4,65,43.6,553376169,398595,100000,553376169,253532514,97528,376897,107855,215773162,107311,184667,94048575,167830
2022-02-18,N/A,US,Admin,USA,United States,76.4,65,43.7,553893534,517365,126573,553893534,253659087,93719,363297,140338,215913500,102809,242628,94291203,162187
2022-02-19,N/A,US,Admin,USA,United States,76.4,65.1,43.7,554172573,279039,76347,554172573,253735434,91415,354254,77169,215990669,99370,122449,94413652,158840
2022-02-20,N/A,US,Admin,USA,United States,76.4,65.1,43.7,554324506,151933,43311,554324506,253778745,91374,354400,41396,216032065,98778,65297,94478949,159558
2022-02-21,N/A,US,Admin,USA,United States,76.5,65.1,43.8,554637988,313482,82152,554637988,253860897,90373,351302,86778,216118843,97462,138729,94617678,158522
2022-02-22,N/A,US,Admin,USA,United States,76.5,65.1,43.8,554977965,339977,89246,554977965,253950143,88692,343599,94306,216213149,94673,150244,94767922,155124
2022-02-23,N/A,US,Admin,USA,United States,76.5,65.2,43.9,555313215,335250,88268,555313215,254038411,86557,333663,90608,216303757,91207,150296,94918218,150616
2022-02-24,N/A,US,Admin,USA,United States,76.5,65.2,43.9,555634511,321296,83879,555634511,254122290,84254,322620,83202,216386959,87685,147716,95065934,145337
2022-02-25,N/A,US,Admin,USA,United States,76.6,65.2,44,556018833,384322,97493,556018833,254219783,80099,303614,102094,216489053,82222,177728,95243662,136066
2022-02-26,N/A,US,Admin,USA,United States,76.6,65.2,44,556259063,240230,67105,556259063,254286888,78779,298070,63268,216552321,80236,106872,95350534,133840
2022-02-27,N/A,US,Admin,USA,United States,76.6,65.2,44,556380670,121607,35259,556380670,254322147,77629,293738,31188,216583509,78778,53748,95404282,132190
2022-02-28,N/A,US,Admin,USA,United States,76.6,65.3,44.1,556688461,307791,78678,556688461,254400825,77133,292925,78452,216661961,77588,144706,95548988,133044
2022-03-01,N/A,US,Admin,USA,United States,76.6,65.3,44.1,556955321,266860,69828,556955321,254470653,74359,282479,70604,216732565,74202,120564,95669552,128804
2022-03-02,N/A,US,Admin,USA,United States,76.7,65.3,44.2,557206554,251233,67884,557206554,254538537,71447,270477,69303,216801868,71159,108716,95778268,122864
2022-03-03,N/A,US,Admin,USA,United States,76.7,65.3,44.2,557454272,247718,65972,557454272,254604509,68888,259966,67112,216868980,68860,109391,95887659,117389
2022-03-04,N/A,US,Admin,USA,United States,76.7,65.3,44.3,557764599,310327,79673,557764599,254684182,66343,249395,85906,216954886,66548,137596,96025255,111656
2022-03-05,N/A,US,Admin,USA,United States,76.7,65.4,44.3,557942316,177717,50367,557942316,254734549,63952,240465,50148,217005034,64673,75118,96100373,107120
2022-03-06,N/A,US,Admin,USA,United States,76.7,65.4,44.3,558029291,86975,26979,558029291,254761528,62769,235517,23765,217028799,63613,35277,96135650,104481
2022-03-07,N/A,US,Admin,USA,United States,76.8,65.4,44.3,558234806,205515,57340,558234806,254818868,59720,220906,53097,217081896,59991,90615,96226265,96754
2022-03-08,N/A,US,Admin,USA,United States,76.8,65.4,44.4,558444971,210165,55952,558444971,254874820,57738,212807,57041,217138937,58053,92182,96318447,92699
2022-03-09,N/A,US,Admin,USA,United States,76.8,65.4,44.4,558652429,207458,56122,558652429,254930942,56058,206554,57432,217196369,56357,89251,96407698,89919
2022-03-10,N/A,US,Admin,USA,United States,76.8,65.4,44.4,558859550,207121,54825,558859550,254985767,54465,200754,57313,217253682,54957,90486,96498184,87218
2022-03-11,N/A,US,Admin,USA,United States,76.8,65.5,44.5,559111967,252417,64629,559111967,255050396,52316,192481,71641,217325323,52920,110281,96608465,83316
2022-03-12,N/A,US,Admin,USA,United States,76.8,65.5,44.5,559250834,138867,39465,559250834,255089861,50759,186931,40095,217365418,51483,57541,96666006,80805
2022-03-13,N/A,US,Admin,USA,United States,76.8,65.5,44.5,559323495,72661,21923,559323495,255111784,50037,184886,20335,217385753,50993,29435,96695441,79970
2022-03-14,N/A,US,Admin,USA,United States,76.9,65.5,44.5,559513285,189790,51428,559513285,255163212,49192,182640,49784,217435537,50520,83119,96778560,78899
2022-03-15,N/A,US,Admin,USA,United States,76.9,65.5,44.5,559711291,198006,52688,559711291,255215900,48726,180903,51145,217486682,49678,87136,96865696,78178
2022-03-16,N/A,US,Admin,USA,United States,76.9,65.5,44.6,559912060,200769,53709,559912060,255269609,48381,179947,50631,217537313,48706,88704,96954400,78100
2022-03-17,N/A,US,Admin,USA,United States,76.9,65.5,44.6,560102947,190887,49769,560102947,255319378,47659,177628,46644,217583957,47182,86615,97041015,77547
2022-03-18,N/A,US,Admin,USA,United States,76.9,65.6,44.6,560349134,246187,63276,560349134,255382654,47465,176738,59785,217643742,45488,112159,97153174,77816
2022-03-19,N/A,US,Admin,USA,United States,76.9,65.6,44.7,560491035,141901,39328,560491035,255421982,47446,177172,35846,217679588,44881,61426,97214600,78371
2022-03-20,N/A,US,Admin,USA,United States,76.9,65.6,44.7,560565020,73985,22828,560565020,255444810,47575,177361,17361,217696949,44457,30957,97245557,78588
2022-03-21,N/A,US,Admin,USA,United States,77,65.6,44.7,560745784,180764,50953,560745784,255495763,47507,176071,42032,217738981,43349,78545,97324102,77935
2022-03-22,N/A,US,Admin,USA,United States,77,65.6,44.7,560920812,175028,47095,560920812,255542858,46708,172789,41563,217780544,41980,77367,97401469,76539
2022-03-23,N/A,US,Admin,USA,United States,77,65.6,44.8,561105818,185006,51689,561105818,255594547,46420,170537,44123,217824667,41051,80654,97482123,75389
2022-03-24,N/A,US,Admin,USA,United States,77,65.6,44.8,561286740,180922,52312,561286740,255646859,46783,169113,41055,217865722,40252,79018,97561141,74304
2022-03-25,N/A,US,Admin,USA,United States,77,65.6,44.8,561510266,223526,61535,561510266,255708394,46534,165876,52302,217918024,39183,99600,97660741,72510
2022-03-26,N/A,US,Admin,USA,United States,77,65.6,44.8,561630459,120193,33925,561630459,255742319,45762,162775,29227,217947251,38238,52501,97713242,71235
2022-03-27,N/A,US,Admin,USA,United States,77,65.6,44.8,561692834,62375,18045,561692834,255760364,45079,161116,14412,217961663,37816,26708,97739950,70628
2022-03-28,N/A,US,Admin,USA,United States,77,65.7,44.9,561859206,166372,50094,561859206,255810458,44956,159060,36380,217998043,37009,69741,97809691,69370
2022-03-29,N/A,US,Admin,USA,United States,77.1,65.7,44.9,562047615,188409,45858,562047615,255856316,44780,160972,38488,218036531,36570,76986,97886677,69315
2022-03-30,N/A,US,Admin,USA,United States,77.1,65.7,44.9,562429422,381807,59535,562429422,255915851,45901,189086,55436,218091967,38186,105308,97991985,72837
2022-03-31,N/A,US,Admin,USA,United States,77.1,65.7,45,562950268,520846,72756,562950268,255988607,48821,237647,63321,218155288,41367,121372,98113357,78888
2022-04-01,N/A,US,Admin,USA,United States,77.1,65.7,45,563554762,604494,75311,563554762,256063918,50789,292071,75354,218230642,44660,138287,98251644,84415
2022-04-02,N/A,US,Admin,USA,United States,77.1,65.7,45,563874518,319756,44243,563874518,256108161,52263,320580,42203,218272845,46513,70856,98322500,87037
2022-04-03,N/A,US,Admin,USA,United States,77.1,65.8,45.1,564068642,194124,27603,564068642,256135764,53629,339401,24779,218297624,47994,40301,98362801,88979
2022-04-04,N/A,US,Admin,USA,United States,77.2,65.8,45.1,564579694,511052,67422,564579694,256203186,56104,388641,58711,218356335,51185,105079,98467880,94027
2022-04-05,N/A,US,Admin,USA,United States,77.2,65.8,45.1,565085361,505667,60574,565085361,256263760,58206,433964,57949,218414284,53965,103566,98571446,97824
2022-04-06,N/A,US,Admin,USA,United States,77.2,65.8,45.2,565608373,523012,62241,565608373,256326001,58593,454136,60561,218474845,54697,108040,98679486,98214
2022-04-07,N/A,US,Admin,USA,United States,77.2,65.8,45.2,566136886,528513,60842,566136886,256386843,56891,455231,59385,218534230,54135,107589,98787075,96245
2022-04-08,N/A,US,Admin,USA,United States,77.2,65.8,45.2,566746237,609351,68904,566746237,256455747,55976,455925,70389,218604619,53425,125057,98912132,94355
2022-04-09,N/A,US,Admin,USA,United States,77.3,65.9,45.3,567052454,306217,42102,567052454,256497849,55670,453991,39530,218644149,53043,63459,98975591,93299
2022-04-10,N/A,US,Admin,USA,United States,77.3,65.9,45.3,567232819,180365,26370,567232819,256524219,55494,452025,23222,218667371,52821,36513,99012104,92758
2022-04-11,N/A,US,Admin,USA,United States,77.3,65.9,45.3,567751472,518653,61479,567751472,256585698,54645,453111,56673,218724044,52530,102622,99114726,92407
2022-04-12,N/A,US,Admin,USA,United States,77.3,65.9,45.4,568285554,534082,59448,568285554,256645146,54484,457170,56087,218780131,52264,103608,99218334,92413
2022-04-13,N/A,US,Admin,USA,United States,77.3,65.9,45.4,568769294,483740,57465,568769294,256702611,53801,451560,53010,218833141,51185,96065,99314399,90702
2022-04-14,N/A,US,Admin,USA,United States,77.3,65.9,45.4,569207141,437847,52414,569207141,256755025,52597,438608,48240,218881381,49593,91054,99405453,88340
2022-04-15,N/A,US,Admin,USA,United States,77.3,65.9,45.4,569542937,335796,42807,569542937,256797832,48869,399529,41195,218922576,45422,75468,99480921,81256
2022-04-16,N/A,US,Admin,USA,United States,77.4,65.9,45.4,569639759,96822,15827,569639759,256813659,45116,369615,14286,218936862,41816,23928,99504849,75608
2022-04-17,N/A,US,Admin,USA,United States,77.4,65.9,45.4,569642898,3139,984,569642898,256814643,41489,344297,499,218937361,38570,1049,99505898,70542
